huntCode,unitDescription,bag,nLicenses,1st,2nd,3rd,T,r1st,r2nd,r3rd,rTot,huntOdds
ANT-1-101,"Units 2, 7, 9, 10: youth only",ES,3,91,13,29,133,91,13,29,133,1.8947368421052633
ANT-1-102,"Units 2, 7, 9, 10",MB,5,368,169,136,673,364,166,133,663,0.6334841628959276
ANT-1-104,Unit 12: youth only,ES,3,36,34,12,82,36,34,11,81,3.111111111111111
ANT-1-105,Unit 12,MB,10,259,207,157,623,233,189,123,545,1.5412844036697249
ANT-1-106,Unit 12: mobility impaired only,MB,10,30,13,14,57,29,9,12,50,16.8
ANT-1-107,Unit 12,MB,10,105,168,144,417,96,153,133,382,2.1989528795811517
ANT-1-109,Unit 13: youth only,ES,2,71,53,72,196,71,52,72,195,0.8615384615384615
ANT-1-110,Unit 13,MB,10,555,421,413,1389,479,373,360,1212,0.6930693069306931
ANT-1-111,Unit 13: mobility impaired only,MB,10,51,34,22,107,40,29,20,89,9.438202247191011
ANT-1-112,Unit 13,MB,5,143,206,179,528,138,202,175,515,0.8155339805825242
ANT-1-114,Unit 15: youth only,ES,5,122,110,75,307,120,110,74,304,1.3815789473684212
ANT-1-115,Unit 15,MB,10,710,475,411,1596,564,394,358,1316,0.6382978723404256
ANT-1-117,Unit 15: mobility impaired only,MB,3,18,29,14,61,18,29,14,61,4.131147540983607
ANT-1-118,Unit 15,MB,10,186,407,278,871,166,362,233,761,1.1038107752956636
ANT-1-120,Unit 16: youth only,ES,5,195,142,88,425,190,142,88,420,1.0
ANT-1-121,Unit 16,MB,15,1950,980,556,3486,900,572,397,1869,0.6741573033707865
ANT-1-123,Unit 16: mobility impaired only,MB,3,39,32,22,93,39,31,22,92,2.7391304347826084
ANT-1-124,Unit 16,MB,25,718,1183,491,2392,396,521,340,1257,1.6706443914081146
ANT-1-126,Unit 17: youth only,ES,5,179,141,113,433,178,140,112,430,0.9767441860465118
ANT-1-127,Unit 17,MB,5,561,408,400,1369,556,397,390,1343,0.3127326880119137
ANT-1-128,Unit 17,MB,5,165,352,212,729,163,345,211,719,0.5841446453407511
ANT-1-129,Unit 17: mobility impaired only,MB,3,33,31,21,85,32,31,21,84,3.0
ANT-1-130,Unit 17,MB,10,248,270,408,926,205,231,357,793,1.0592686002522067
ANT-1-132,Unit 18,MB,15,996,685,742,2423,560,350,336,1246,1.0112359550561798
ANT-1-133,Unit 18,MB,15,325,560,574,1459,214,376,269,859,1.4668218859138533
ANT-1-134,"Unit 19: WSMR only, youth only",ES,5,109,32,21,162,108,32,21,161,2.608695652173913
ANT-1-136,Unit 20: youth only,ES,2,27,23,24,74,27,23,24,74,2.27027027027027
ANT-1-137,Unit 20,MB,10,195,185,226,606,190,180,212,582,1.443298969072165
ANT-1-139,"Units 21, 24: youth only",ES,10,211,110,82,403,134,88,75,297,2.8282828282828283
ANT-1-140,"Units 21, 24",MB,5,343,202,217,762,339,195,215,749,0.5607476635514019
ANT-1-141,"Units 21, 24",MB,10,232,397,229,858,167,351,205,723,1.161825726141079
ANT-1-142,"Units 21, 24: mobility impaired only",MB,8,33,18,25,76,29,16,23,68,9.88235294117647
ANT-1-143,"Units 21, 24",MB,15,199,223,359,781,139,147,284,570,2.2105263157894735
ANT-1-145,"Units 22, 23: youth only",ES,5,90,53,39,182,89,53,39,181,2.3204419889502765
ANT-1-146,"Units 22, 23",MB,5,266,166,137,569,263,162,129,554,0.7581227436823105
ANT-1-147,"Units 22, 23",MB,10,215,398,223,836,129,270,194,593,1.4165261382799326
ANT-1-148,"Units 22, 23: mobility impaired only",MB,3,18,15,6,39,18,15,6,39,6.461538461538462
ANT-1-150,"Units 25, 26, 27: youth only",ES,5,38,65,62,165,38,65,62,165,2.5454545454545454
ANT-1-151,"Units 25, 26, 27",MB,5,237,140,162,539,233,137,159,529,0.7939508506616257
ANT-1-152,"Units 25, 26, 27",MB,10,335,317,232,884,120,234,172,526,1.596958174904943
ANT-1-153,"Units 25, 26, 27: mobility impaired only",MB,3,13,7,15,35,12,7,15,34,7.411764705882352
ANT-1-161,Unit 31 north of US 380: youth only,ES,5,88,66,27,181,86,66,26,178,2.359550561797753
ANT-1-162,Unit 31 north of US 380,MB,5,265,142,132,539,249,137,131,517,0.8123791102514507
ANT-1-163,Unit 31 north of US 380,MB,10,131,214,130,475,115,199,115,429,1.9580419580419581
ANT-1-164,Unit 31 north of US 380: mobility impaired only,MB,5,16,9,7,32,16,9,7,32,13.125
ANT-1-165,Unit 31 north of US 380,MB,15,167,150,203,520,128,97,159,384,3.28125
ANT-1-167,Unit 31 south of US 380: youth only,ES,5,130,82,40,252,130,82,40,252,1.6666666666666667
ANT-1-168,Unit 31 south of US 380,MB,10,609,374,263,1246,487,260,226,973,0.8633093525179856
ANT-1-169,Unit 31 south of US 380,MB,10,140,527,273,940,130,431,216,777,1.0810810810810811
ANT-1-170,Unit 31 south of US 380: mobility impaired only,MB,5,17,17,11,45,17,17,11,45,9.333333333333334
ANT-1-171,Unit 31 south of US 380,MB,20,231,284,591,1106,149,219,417,785,2.140127388535032
ANT-1-173,Unit 32 east of Pecos River: youth only,ES,5,89,47,62,198,89,46,62,197,2.1319796954314723
ANT-1-174,Unit 32 east of Pecos River,MB,10,289,226,269,784,280,217,218,715,1.1748251748251748
ANT-1-175,Unit 32 east of Pecos River,MB,5,94,179,100,373,93,177,98,368,1.141304347826087
ANT-1-176,Unit 32 east of Pecos River: mobility impaired only,MB,5,17,9,19,45,17,9,19,45,9.333333333333334
ANT-1-177,Unit 32 east of Pecos River,MB,15,123,139,278,540,92,111,195,398,3.165829145728643
ANT-1-179,Unit 32 west of Pecos River,MB,15,538,449,413,1400,426,320,294,1040,1.2115384615384615
ANT-1-180,Unit 32 west of Pecos River,MB,10,118,371,184,673,108,341,157,606,1.3861386138613863
ANT-1-181,Unit 32 west of Pecos River: mobility impaired only,MB,5,13,15,12,40,13,15,12,40,10.500000000000002
ANT-1-182,Unit 32 west of Pecos River,MB,15,145,187,357,689,115,149,293,557,2.2621184919210053
ANT-1-183,Unit 32 (Roswell Hunt Area only),F-IM,15,58,42,115,215,53,33,107,193,6.528497409326425
ANT-1-185,Unit 33: youth only,ES,5,108,67,75,250,107,67,74,248,1.6935483870967745
ANT-1-186,Unit 33,MB,25,903,475,529,1907,613,322,360,1295,1.6216216216216217
ANT-1-187,Unit 33,MB,20,187,727,321,1235,147,544,240,931,1.8045112781954888
ANT-1-188,Unit 33: mobility impaired only,MB,5,23,21,14,58,23,21,14,58,7.241379310344828
ANT-1-189,Unit 33,MB,25,192,261,592,1045,154,160,428,742,2.8301886792452833
ANT-1-191,"Units 36, 37: youth only",ES,5,68,49,35,152,68,49,33,150,2.8000000000000003
ANT-1-192,"Units 36, 37",MB,10,299,200,202,701,279,181,188,648,1.2962962962962965
ANT-1-193,"Units 36, 37",MB,10,76,241,151,468,73,231,142,446,1.883408071748879
ANT-1-194,"Units 36, 37: mobility impaired only",MB,5,8,13,19,40,8,13,19,40,10.500000000000002
ANT-1-195,"Units 36, 37",MB,15,134,198,269,601,78,122,212,412,3.058252427184466
ANT-1-197,Unit 38: youth only,ES,10,116,83,96,295,106,68,75,249,3.3734939759036147
ANT-1-198,Unit 38,MB,15,607,340,361,1308,372,253,274,899,1.4015572858731924
ANT-1-199,Unit 38,MB,20,158,415,294,867,122,333,248,703,2.3897581792318636
ANT-1-200,Unit 38: mobility impaired only,MB,10,42,25,27,94,40,22,24,86,9.767441860465116
ANT-1-201,Unit 38,MB,30,185,205,367,757,157,169,284,610,4.131147540983606
ANT-1-203,Unit 39: youth only,ES,5,58,37,26,121,58,37,26,121,3.4710743801652892
ANT-1-204,Unit 39,MB,10,217,173,143,533,213,169,141,523,1.6061185468451245
ANT-1-205,Unit 39,MB,10,77,185,103,365,73,181,101,355,2.3661971830985915
ANT-1-206,Unit 39: mobility impaired only,MB,5,12,15,8,35,12,15,8,35,12.000000000000002
ANT-1-207,Unit 39,MB,10,46,56,149,251,46,56,147,249,3.3734939759036147
ANT-1-209,Unit 40,MB,10,146,84,88,318,136,72,78,286,2.9370629370629375
ANT-1-210,Unit 40: mobility impaired only,MB,5,11,7,3,21,11,7,3,21,20.0
ANT-1-211,Unit 40,MB,10,65,65,85,215,64,63,70,197,4.2639593908629445
ANT-1-213,Unit 41: youth only,ES,5,33,24,19,76,33,24,19,76,5.526315789473685
ANT-1-214,Unit 41,MB,30,286,218,237,741,227,154,162,543,4.640883977900552
ANT-1-215,Unit 41,MB,30,103,237,174,514,83,201,130,414,6.08695652173913
ANT-1-216,Unit 41: mobility impaired only,MB,5,5,8,11,24,5,8,11,24,17.5
ANT-1-217,Unit 41,MB,35,98,118,276,492,78,97,239,414,7.101449275362319
ANT-1-218,Unit 41: youth only,F-IM,10,0,9,10,19,0,9,10,19,44.21052631578948
ANT-1-220,Unit 42: youth only,ES,10,19,22,32,73,16,21,32,69,12.173913043478262
ANT-1-221,Unit 42,MB,10,49,83,83,215,48,82,81,211,3.9810426540284363
ANT-1-222,Unit 42,MB,10,52,54,80,186,52,50,79,181,4.640883977900553
ANT-1-224,"Units 8, 43",MB,10,152,147,184,483,150,142,176,468,1.7948717948717952
ANT-1-226,Unit 47: youth only,ES,5,56,53,65,174,56,53,63,172,2.441860465116279
ANT-1-227,Unit 47,MB,25,538,371,402,1311,455,300,315,1070,1.9626168224299065
ANT-1-228,Unit 47,MB,30,131,413,330,874,111,364,290,765,3.294117647058824
ANT-1-229,Unit 47: mobility impaired only,MB,5,18,13,12,43,18,13,12,43,9.767441860465116
ANT-1-230,Unit 47,MB,35,161,203,324,688,126,179,269,574,5.121951219512195
ANT-1-231,Unit 47: youth only,F-IM,20,19,14,30,63,19,14,29,62,27.09677419354839
ANT-1-234,"Units 50, 52",MB,20,1948,593,391,2932,1785,527,350,2662,0.6311044327573253
ANT-1-237,Unit 56: youth only,ES,50,338,241,101,680,260,199,79,538,7.806691449814126
ANT-1-238,Unit 56,MB,5,403,322,354,1079,400,317,346,1063,0.3951081843838194
ANT-1-239,Unit 56,MB,45,699,757,484,1940,550,644,413,1607,2.3522090852520225
ANT-1-240,Unit 56: mobility impaired only,MB,5,13,24,23,60,12,24,23,59,7.118644067796611
ANT-1-241,Unit 56,MB,50,338,467,503,1308,256,382,428,1066,3.9399624765478425
ANT-1-242,Unit 56: youth only,F-IM,40,13,43,56,112,12,38,54,104,32.30769230769231
ANT-1-244,Unit 57: youth only,ES,5,18,25,22,65,18,25,22,65,6.461538461538462
ANT-1-245,Unit 57,MB,5,47,72,90,209,46,72,87,205,2.048780487804878
ANT-1-246,Unit 57: youth only,F-IM,5,0,2,8,10,0,2,8,10,42.00000000000001
ANT-1-248,Unit 58: youth only,ES,20,83,110,115,308,60,70,79,209,8.038277511961722
ANT-1-249,Unit 58,MB,30,403,345,261,1009,312,267,211,790,3.189873417721519
ANT-1-250,Unit 58,MB,30,106,329,253,688,86,260,193,539,4.675324675324675
ANT-1-251,Unit 58: mobility impaired only,MB,5,16,10,11,37,16,9,11,36,11.666666666666666
ANT-1-252,Unit 58,MB,40,146,210,295,651,114,172,229,515,6.524271844660194
ANT-1-253,Unit 58: youth only,F-IM,35,7,16,45,68,6,15,41,62,47.41935483870968
ANT-1-255,Unit 59: youth only,ES,45,188,215,216,619,170,161,158,489,7.730061349693251
ANT-1-256,Unit 59,MB,5,293,256,321,870,290,246,309,845,0.49704142011834324
ANT-1-257,Unit 59,MB,40,424,601,537,1562,353,489,431,1273,2.6394344069128044
ANT-1-258,Unit 59: mobility impaired only,MB,10,37,19,28,84,37,19,24,80,10.500000000000002
ANT-1-259,Unit 59,MB,50,230,377,518,1125,188,285,420,893,4.703247480403135
ANT-1-260,Unit 59: youth only,F-IM,40,20,48,54,122,19,46,52,117,28.717948717948723
ANT-2-100,"Units 2, 7, 9, 10",MB,10,67,53,35,155,63,53,34,150,5.6000000000000005
ANT-2-103,Unit 12,MB,10,48,23,43,114,43,20,37,100,8.4
ANT-2-108,Unit 13,MB,10,100,77,108,285,94,75,100,269,3.122676579925651
ANT-2-113,Unit 15,MB,20,184,144,153,481,117,113,113,343,4.8979591836734695
ANT-2-119,Unit 16,MB,20,279,195,138,612,191,127,89,407,4.127764127764128
ANT-2-125,Unit 17,MB,20,192,210,190,592,157,156,136,449,3.7416481069042313
ANT-2-131,Unit 18,MB,25,147,108,147,402,98,58,106,262,8.015267175572518
ANT-2-135,Unit 20,MB,10,18,36,49,103,17,36,48,101,8.316831683168317
ANT-2-138,"Units 21, 24",MB,25,89,88,131,308,68,68,103,239,8.786610878661087
ANT-2-144,"Units 22, 23",MB,10,52,61,48,161,46,53,39,138,6.086956521739131
ANT-2-149,"Units 25, 26, 27",MB,10,50,46,64,160,41,35,55,131,6.412213740458015
ANT-2-159,Unit 30,MB,25,127,56,105,288,109,47,81,237,8.860759493670885
ANT-2-160,Unit 31 north of US 380,MB,25,85,156,97,338,69,122,61,252,8.333333333333332
ANT-2-166,Unit 31 south of US 380,MB,50,264,162,156,582,216,116,114,446,9.417040358744394
ANT-2-172,Unit 32 east of Pecos River,MB,25,52,75,95,222,44,59,79,182,11.538461538461538
ANT-2-178,Unit 32 west of Pecos River,MB,20,82,91,97,270,68,62,67,197,8.527918781725889
ANT-2-184,Unit 33,MB,30,121,112,144,377,98,87,111,296,8.513513513513512
ANT-2-190,"Units 36, 37",MB,20,51,58,86,195,38,47,64,149,11.275167785234899
ANT-2-196,Unit 38,MB,20,72,68,71,211,51,61,53,165,10.181818181818182
ANT-2-202,Unit 39,MB,5,39,24,19,82,39,23,16,78,5.384615384615385
ANT-2-208,Unit 40,MB,5,19,21,17,57,19,19,16,54,7.777777777777778
ANT-2-212,Unit 41,MB,35,40,25,100,165,38,21,83,142,20.704225352112676
ANT-2-219,Unit 42,MB,5,13,8,14,35,13,8,14,35,12.000000000000002
ANT-2-223,"Units 8, 43",MB,5,21,19,24,64,21,19,24,64,6.5625
ANT-2-225,Unit 47,MB,10,30,35,40,105,28,32,38,98,8.571428571428571
ANT-2-233,"Units 50, 52",MB,20,217,152,205,574,202,136,189,527,3.1878557874762814
ANT-2-236,Unit 56,MB,50,112,118,105,335,90,96,92,278,15.107913669064748
ANT-2-243,Unit 57,MB,5,9,11,11,31,9,11,11,31,13.548387096774196
ANT-2-247,Unit 58,MB,40,38,66,97,201,31,54,76,161,20.869565217391305
ANT-2-254,Unit 59,MB,50,87,94,126,307,73,78,104,255,16.470588235294116
ANT-3-154,Unit 28: McGregor Range only,MB,7,157,85,96,338,144,67,88,299,1.9665551839464883
ANT-3-155,"Unit 28: McGregor Range only, military only",MB,7,32,7,4,43,15,4,2,21,27.999999999999996
ANT-3-156,Unit 29: youth only,ES,5,30,11,17,58,30,10,16,56,7.5
ANT-3-157,Unit 29,MB,15,303,278,165,746,212,191,88,491,2.566191446028513
ANT-3-158,Unit 29,MB,25,158,325,300,783,108,234,195,537,3.910614525139665
ANT-3-232,"Units 50, 52: youth only",ES,40,122,52,55,229,93,42,41,176,19.090909090909093
ANT-3-235,"Units 50, 52",MB,40,714,711,370,1795,633,661,312,1606,2.0921544209215446
BBY-1-101,"GMUs 32, 36, 37",ES,50,643,379,284,1306,544,317,219,1080,3.888888888888889
BBY-1-102,"GMUs 32, 36, 37",ES,50,453,519,340,1312,365,419,252,1036,4.054054054054054
BBY-1-103,"GMUs 32, 36, 37",ES,75,266,403,406,1075,198,299,321,818,7.701711491442542
BBY-1-104,"GMUs 32, 36, 37",ES,150,551,570,549,1670,406,427,384,1217,10.353327855382087
BBY-1-105,"GMUs 32, 36, 37",ES,150,388,572,597,1557,287,398,426,1111,11.341134113411341
BBY-1-106,"GMUs 32, 36, 37",ES,150,265,546,724,1535,146,382,491,1019,12.365063788027477
BBY-1-107,"GMUs 32, 36, 37",ES,150,219,297,701,1217,140,205,489,834,15.107913669064748
BBY-1-109,"GMUs 29, 30",ES,75,2337,835,254,3426,1618,585,201,2404,2.6206322795341097
BBY-1-110,"GMUs 29, 30",ES,75,1466,1770,639,3875,811,1213,481,2505,2.5149700598802394
BBY-1-111,"GMUs 29, 30",ES,75,611,1116,986,2713,326,682,684,1692,3.723404255319149
BBY-1-112,"GMUs 29, 30",ES,200,1587,1298,1302,4187,914,803,842,2559,6.565064478311841
BBY-1-113,"GMUs 29, 30",ES,200,971,1474,1240,3685,539,844,760,2143,7.839477368175456
BBY-1-114,"GMUs 29, 30",ES,200,664,1323,1287,3274,258,780,808,1846,9.100758396533044
BBY-1-115,"GMUs 29, 30",ES,200,498,805,1543,2846,290,396,972,1658,10.132689987937274
BBY-1-116,Unit 28 McGregor range,ES,10,2106,175,146,2427,1616,131,137,1884,0.445859872611465
BBY-1-117,"Unit 28 McGregor range, military only",ES,10,95,17,5,117,64,7,2,73,11.506849315068493
BBY-1-118,Unit 28 McGregor range,F-IM,80,94,178,93,365,64,165,75,304,22.10526315789474
BBY-1-119,"Unit 28 McGregor range, military only",F-IM,10,4,20,20,44,0,14,15,29,28.965517241379313
BBY-1-120,Unit 28 McGregor range,F-IM,50,51,92,169,312,30,69,149,248,16.93548387096774
BBY-1-121,"Unit 28 McGregor range, military only",F-IM,10,4,7,22,33,2,1,13,16,52.5
BBY-2-100,"GMUs 32, 36, 37",ES,75,89,99,73,261,56,46,44,146,43.15068493150685
BBY-2-108,"GMUs 29, 30",ES,75,176,100,180,456,77,53,95,225,28.000000000000004
BHS-1-201,(TBD by hunt area selected),RAM,27,9665,3532,107,13304,5906,1698,98,7702,0.29446896909893533
BHS-1-202,Unit 45,EWE,20,149,756,1781,2686,134,718,1679,2531,0.6637692611615963
BHS-1-204,(TBD by hunt area selected),RAM,24,4899,6812,489,12200,2598,3688,457,6743,0.2989767165949874
BHS-2-203,Unit 45,EWE,10,84,127,465,676,78,127,456,661,1.270801815431165
DER-1-100,Unit 2A: youth only,FAD,25,64,62,64,190,63,54,53,170,12.352941176470589
DER-1-101,Unit 2A,FAD,150,491,444,616,1551,445,402,550,1397,9.019327129563349
DER-1-102,Unit 2A: private land only,FAD,40,17,1,8,26,14,1,8,23,146.08695652173913
DER-1-103,Unit 2A: youth only,FAD,15,97,220,161,478,71,135,113,319,3.949843260188088
DER-1-110,Unit 2B,FAD,275,1249,908,1060,3217,1150,794,921,2865,8.06282722513089
DER-1-111,Unit 2B: youth only,FAD,125,301,210,142,653,276,180,132,588,17.857142857142858
DER-1-112,Unit 2B: private land only,FAD,25,1,6,9,16,1,5,9,15,140.0
DER-1-113,Unit 2B,FAD,350,1029,2144,1177,4350,882,1861,950,3693,7.961007311129163
DER-1-114,Unit 2B: private land only,FAD,25,4,11,4,19,2,6,4,12,175.0
DER-1-115,Unit 2B,FAD,400,3612,2516,2069,8197,2901,1949,1569,6419,5.2344601962922575
DER-1-116,Unit 2B: private land only,FAD,75,28,6,19,53,19,2,10,31,203.2258064516129
DER-1-117,Unit 2B: youth only,FAD,25,1500,591,260,2351,875,404,189,1468,1.430517711171662
DER-1-127,Unit 2C,FAD,30,6836,1564,1095,9495,2276,1029,846,4151,0.6070826306913997
DER-1-128,Unit 2C: private land only,FAD,8,15,4,6,25,13,4,6,23,29.217391304347824
DER-1-133,Unit 4: Humphries/Rio Chama/Sargent WMAs only,FAD,20,305,147,162,614,302,146,162,610,2.754098360655738
DER-1-134,"Unit 4: Humphries/Rio Chama/Sargent WMAs only, youth only",FAD,10,45,56,35,136,44,56,34,134,6.268656716417912
DER-1-135,Unit 4: private land only,FAD,175,119,37,74,230,62,27,71,160,91.875
DER-1-136,Unit 4: Humphries/Rio Chama/Sargent WMAs only,FAD,20,178,249,152,579,177,246,152,575,2.9217391304347826
DER-1-137,Unit 4: private land only,FAD,175,96,105,36,237,56,91,34,181,81.21546961325967
DER-1-138,Unit 4: Humphries/Rio Chama/Sargent WMAs only,FAD,10,307,262,265,834,302,259,264,825,1.0181818181818183
DER-1-139,Unit 4: private land only,FAD,10,116,33,36,185,108,33,35,176,4.772727272727273
DER-1-140,"Unit 4: Humphries/Rio Chama/Sargent WMAs only, youth only",FAD,5,183,129,88,400,183,128,87,398,1.0552763819095479
DER-1-144,Unit 5A: public land only,FAD,40,203,206,239,648,190,188,194,572,5.874125874125875
DER-1-145,Unit 5A: private land only,FAD,220,127,3,12,142,64,2,12,78,236.92307692307688
DER-1-150,Unit 5B,FAD,30,1880,3392,1072,6344,1377,1172,767,3316,0.7599517490952955
DER-1-151,Unit 5B: youth only,FAD,10,438,407,176,1021,344,255,144,743,1.1305518169582773
DER-1-154,Units 6A and 6C: mobility impaired only,FAD,20,131,63,39,233,120,62,36,218,7.706422018348624
DER-1-155,Units 6A and 6C,FAD,110,2266,2008,1599,5873,2092,1838,1445,5375,1.7190697674418602
DER-1-158,Unit 7,FAD,30,259,634,646,1539,205,300,347,852,2.9577464788732395
DER-1-164,"Unit 9, including Water Canyon WMA",FAD,15,196,140,155,491,194,134,151,479,2.6304801670146136
DER-1-165,Unit 9: Marquez/LBar WMAs only,FAD,10,112,96,76,284,112,96,75,283,2.9681978798586575
DER-1-166,"Unit 9, including Water Canyon WMA: youth only",FAD,10,49,43,45,137,47,43,43,133,6.315789473684211
DER-1-170,Unit 10: mobility impaired only,FAD,20,41,25,22,88,41,24,22,87,19.310344827586206
DER-1-171,Unit 10,FAD,70,531,326,294,1151,513,305,281,1099,5.350318471337579
DER-1-172,Unit 10,FAD,65,108,504,289,901,101,487,281,869,6.283084004602991
DER-1-173,Unit 10,FAD,90,242,315,538,1095,232,306,513,1051,7.193149381541389
DER-1-174,Unit 10: youth only,FAD,25,76,57,52,185,75,53,51,179,11.731843575418994
DER-1-177,Unit 12,FAD,85,197,146,181,524,151,131,159,441,16.19047619047619
DER-1-180,Unit 13,FAD,150,634,619,677,1930,620,588,630,1838,6.855277475516866
DER-1-181,Unit 13,FAD,150,234,603,581,1418,220,575,530,1325,9.50943396226415
DER-1-182,Unit 13: youth only,FAD,50,87,130,153,370,83,123,139,345,12.173913043478262
DER-1-186,Unit 14,FAD,55,1194,710,475,2379,1142,653,438,2233,2.0689655172413794
DER-1-194,Unit 16,FAD,300,1451,1119,998,3568,1261,970,897,3128,8.05626598465473
DER-1-195,Unit 16: mobility impaired only,FAD,25,65,38,32,135,62,35,32,129,16.27906976744186
DER-1-196,Unit 16,FAD,300,536,1158,901,2595,401,982,778,2161,11.661267931513189
DER-1-197,Unit 16: youth only,FAD,100,135,176,244,555,121,161,218,500,16.8
DER-1-201,Unit 17,FAD,80,1350,1020,884,3254,1190,919,814,2923,2.299007868628122
DER-1-202,Unit 17,FAD,80,437,1090,753,2280,370,935,643,1948,3.449691991786448
DER-1-203,Unit 17: youth only,FAD,80,278,310,287,875,247,248,227,722,9.307479224376731
DER-1-207,Unit 18,FAD,70,254,313,295,862,239,299,268,806,7.295285359801489
DER-1-208,Unit 18,FAD,70,70,277,269,616,60,250,255,565,10.4070796460177
DER-1-212,Unit 19: White Sands missile range only ,FAD,5,115,91,42,248,114,90,40,244,1.7213114754098362
DER-1-213,Unit 19: White Sands missile range only,FAD,5,161,134,90,385,158,134,90,382,1.0994764397905759
DER-1-216,Unit 20,FAD,90,452,303,372,1127,414,279,352,1045,7.234449760765551
DER-1-217,Unit 20,FAD,90,99,372,259,730,86,335,234,655,11.541984732824426
DER-1-221,Unit 21,FAD,425,822,713,843,2378,748,637,760,2145,16.643356643356643
DER-1-222,Unit 21,FAD,425,280,711,621,1612,237,626,558,1421,25.12315270935961
DER-1-223,Unit 21: youth only,FAD,100,61,128,165,354,59,116,159,334,25.149700598802394
DER-1-227,Unit 21,FAWTD,25,79,76,153,308,55,52,125,232,9.051724137931034
DER-1-228,Unit 22,FAD,70,143,133,168,444,94,105,140,339,17.345132743362832
DER-1-229,Unit 22,FAD,70,44,127,136,307,29,81,87,197,29.84771573604061
DER-1-230,Unit 22: youth only,FAD,20,7,13,22,42,6,12,18,36,46.666666666666664
DER-1-234,Unit 23: except Burro mountains hunt area,FAMD,450,608,519,547,1674,485,426,460,1371,27.571115973741794
DER-1-235,Unit 23: except Burro mountains hunt area,FAMD,450,171,526,382,1079,116,402,322,840,45.0
DER-1-236,Unit 23: except Burro mountains hunt area,FAWTD,100,142,242,195,579,102,146,132,380,22.105263157894736
DER-1-237,Unit 23: except Burro mountains hunt area,FAWTD,55,170,292,199,661,92,134,83,309,14.951456310679609
DER-1-238,"Unit 23: except Burro mountains hunt area, youth only",FAD,75,58,100,130,288,46,74,101,221,28.50678733031674
DER-1-245,Unit 23: Burro mountains hunt area only,FAMD,35,473,258,306,1037,402,178,241,821,3.580998781973203
DER-1-246,Unit 23: Burro mountains hunt area only,FAWTD,40,507,342,287,1136,243,183,134,560,6.000000000000001
DER-1-247,"Unit 23: Burro mountains hunt area only, youth only",FAD,25,162,181,136,479,123,116,85,324,6.481481481481481
DER-1-253,Unit 24: including Fort Bayard,FAD,50,173,89,58,320,172,84,49,305,13.77049180327869
DER-1-254,Unit 24: excluding Fort Bayard ,FAMD,400,599,415,517,1531,536,373,453,1362,24.669603524229075
DER-1-255,Unit 24: excluding Fort Bayard ,FAMD,400,145,512,389,1046,114,466,307,887,37.88049605411499
DER-1-256,Unit 24: excluding Fort Bayard ,FAWTD,100,85,133,218,436,49,88,150,287,29.268292682926827
DER-1-257,"Unit 24: including Fort Bayard, youth only",FAD,50,64,160,134,358,62,146,99,307,13.680781758957655
DER-1-258,Unit 24: excluding Fort Bayard ,FAWTD,50,134,162,233,529,76,93,117,286,14.685314685314685
DER-1-265,Unit 25,FAD,100,319,190,180,689,299,174,165,638,13.166144200626958
DER-1-266,Unit 25,FAD,100,68,232,148,448,55,221,136,412,20.388349514563107
DER-1-270,Unit 26,FAD,100,140,117,160,417,117,108,141,366,22.950819672131146
DER-1-271,Unit 26,FAD,100,55,102,111,268,49,86,86,221,38.009049773755656
DER-1-275,Unit 26,FAWTD,25,42,38,45,125,23,27,29,79,26.582278481012654
DER-1-276,Unit 27,FAMD,50,103,100,111,314,85,83,82,250,16.8
DER-1-277,Unit 27,FAMD,50,40,81,77,198,31,62,58,151,27.81456953642384
DER-1-278,Unit 27,FAWTD,40,166,185,168,519,115,101,78,294,11.428571428571429
DER-1-279,Unit 27: youth only,FAD,25,42,54,48,144,26,29,30,85,24.705882352941178
DER-1-280,Unit 27,FAWTD,25,300,278,197,775,127,107,74,308,6.8181818181818175
DER-1-287,Unit 28: McGregor range only,FAD,25,219,132,115,466,176,92,90,358,5.865921787709497
DER-1-288,"Unit 28: McGregor range only, military only",FAD,25,60,17,8,85,32,6,6,44,47.72727272727273
DER-1-289,Unit 29,FAD,150,92,89,155,336,75,77,128,280,45.0
DER-1-290,Unit 29,FAD,150,57,116,169,342,45,97,147,289,43.59861591695502
DER-1-294,Unit 30,FAD,720,1907,896,820,3623,1674,768,751,3193,18.941434387723145
DER-1-295,Unit 30,FAD,720,789,1667,873,3329,626,1469,783,2878,21.01459346768589
DER-1-296,Unit 30: youth only,FAD,250,268,71,186,525,243,63,162,468,44.871794871794876
DER-1-300,Unit 31,FAD,440,1746,1013,1127,3886,1532,856,1003,3391,10.899439693305808
DER-1-301,Unit 31,FAD,435,594,1588,906,3088,467,1358,761,2586,14.129930394431552
DER-1-305,Unit 32,FAD,565,728,510,650,1888,673,463,604,1740,27.275862068965516
DER-1-306,Unit 32,FAD,560,352,651,670,1673,317,576,604,1497,31.42284569138276
DER-1-307,"Unit 32: Roswell and Ft. Sumner hunt areas only, youth only",A,15,21,46,46,113,21,46,44,111,11.35135135135135
DER-1-308,Unit 32: Roswell and Ft. Sumner hunt areas only,A,15,43,49,165,257,41,44,157,242,5.206611570247934
DER-1-312,Unit 33,FAD,150,1027,671,631,2329,885,557,553,1995,6.315789473684211
DER-1-313,Unit 33,FAD,150,522,892,539,1953,416,749,422,1587,7.9395085066162565
DER-1-319,Unit 34: mobility impaired only,FAD,50,104,32,34,170,99,30,32,161,26.08695652173913
DER-1-320,Unit 34: youth only,FAD,45,205,150,119,474,188,143,110,441,8.57142857142857
DER-1-321,Unit 34,FAD,650,1750,1078,1293,4121,1582,981,1162,3725,14.657718120805368
DER-1-322,Unit 34,FAD,650,497,1405,1038,2940,439,1244,922,2605,20.959692898272554
DER-1-326,Unit 36,FAD,300,1021,779,895,2695,903,705,781,2389,10.548346588530766
DER-1-327,Unit 36,FAD,300,419,954,655,2028,362,835,573,1770,14.237288135593221
DER-1-328,Unit 36: youth only,FAD,25,158,159,131,448,142,132,116,390,5.384615384615385
DER-1-333,Unit 37,FAD,365,661,666,802,2129,588,581,704,1873,16.369460758142015
DER-1-334,Unit 37,FAD,360,351,576,589,1516,268,524,539,1331,22.71975957926371
DER-1-338,Unit 38,FAD,160,176,255,308,739,170,247,296,713,18.84992987377279
DER-1-339,Unit 38,FAD,155,104,161,244,509,93,144,233,470,27.702127659574465
DER-1-343,Unit 39,FAD,35,63,78,51,192,60,75,47,182,16.153846153846153
DER-1-344,Unit 39,FAD,35,43,66,84,193,41,62,77,180,16.333333333333332
DER-1-348,Unit 40,FAD,50,58,41,104,203,52,40,98,190,22.105263157894736
DER-1-349,Unit 40,FAD,50,36,56,68,160,33,53,62,148,28.37837837837838
DER-1-353,Unit 41,FAD,40,147,92,81,320,125,82,71,278,12.086330935251798
DER-1-354,Unit 41,FAD,40,67,140,80,287,54,115,59,228,14.73684210526316
DER-1-355,Unit 41: youth only,FAD,5,46,21,22,89,45,19,22,86,4.883720930232558
DER-1-356,Unit 41: youth only,ESWTD,15,3,3,5,11,3,2,5,10,126.0
DER-1-357,Unit 41,ESWTD,10,6,18,22,46,5,18,21,44,19.090909090909093
DER-1-361,Unit 42,FAD,40,45,35,34,114,40,27,34,101,33.26732673267327
DER-1-362,Unit 42,FAD,40,19,47,77,143,17,41,73,131,25.64885496183206
DER-1-363,Unit 42,ESWTD,10,11,8,15,34,11,8,15,34,24.705882352941178
DER-1-366,Unit 43,FAD,35,142,124,217,483,136,121,213,470,6.25531914893617
DER-1-369,Unit 45,FAD,250,1066,946,831,2843,994,876,765,2635,7.969639468690702
DER-1-370,Unit 45: mobility impaired only,FAD,25,30,38,35,103,29,36,35,100,21.0
DER-1-371,Unit 45,FAD,250,526,1059,1001,2586,492,990,894,2376,8.83838383838384
DER-1-372,Unit 45: youth only,FAD,25,208,129,182,519,194,111,147,452,4.646017699115045
DER-1-375,Unit 47,FAD,25,53,37,52,142,50,33,43,126,16.666666666666664
DER-1-376,Unit 47,FAD,20,20,47,39,106,17,44,38,99,16.969696969696972
DER-1-379,Unit 48,FAD,50,236,216,178,630,222,203,171,596,7.046979865771812
DER-1-380,Unit 48,FAD,50,71,165,188,424,68,154,178,400,10.5
DER-1-383,Unit 49,FAD,100,768,520,488,1776,714,475,453,1642,5.115712545676005
DER-1-384,Unit 49,FAD,100,262,736,490,1488,234,671,428,1333,6.301575393848462
DER-1-386,Unit 50,FAD,50,85,143,162,390,78,129,152,359,11.699164345403899
DER-1-387,Unit 50,FAD,50,53,126,217,396,45,117,212,374,11.229946524064172
DER-1-389,Unit 51A,FAD,145,910,738,901,2549,864,695,856,2415,5.043478260869565
DER-1-391,Unit 51B,FAD,20,169,311,217,697,153,301,198,652,2.5766871165644174
DER-1-392,Unit 51B,FAD,15,87,204,335,626,84,186,322,592,2.128378378378378
DER-1-394,Unit 52,FAD,90,399,565,549,1513,355,503,478,1336,5.658682634730539
DER-1-395,Unit 52,FAD,90,270,588,599,1457,218,517,523,1258,6.00953895071542
DER-1-398,Unit 53,FAD,85,266,233,223,722,234,199,197,630,11.333333333333332
DER-1-399,Unit 53,FAD,85,143,308,323,774,113,271,270,654,10.91743119266055
DER-1-401,Units 54/55: Colin Neblett WMA only,FAD,10,23,30,37,90,23,30,37,90,9.333333333333334
DER-1-402,Units 54/55: Colin Neblett WMA only,FAD,10,11,28,38,77,11,28,38,77,10.90909090909091
DER-1-404,Unit 55: ES Barker WMA only,FAD,5,28,24,28,80,28,24,28,80,5.250000000000001
DER-1-405,"Unit 55: ES Barker WMA only, youth only",FAD,5,13,9,10,32,13,9,10,32,13.125
DER-1-406,Unit 55: Urraca WMA only,FAD,5,8,15,28,51,8,15,28,51,8.235294117647058
DER-1-407,Unit 55: Urraca WMA only,FAD,5,7,14,27,48,7,14,27,48,8.75
DER-1-409,Unit 56,FAD,15,40,33,34,107,34,27,32,93,13.548387096774192
DER-1-410,Unit 56,FAD,15,22,26,31,79,20,22,26,68,18.529411764705884
DER-1-411,Unit 56: youth only,FAD,10,13,7,16,36,12,6,16,34,24.705882352941178
DER-1-412,Unit 56: youth only,ESWTD,10,3,3,8,14,3,3,7,13,64.61538461538461
DER-1-415,Unit 57 (excluding Sugarite Canyon State Park),FAD,25,55,50,33,138,47,43,27,117,17.94871794871795
DER-1-416,Unit 57 (excluding Sugarite Canyon State Park),FAD,25,17,51,36,104,13,50,30,93,22.58064516129032
DER-1-417,Unit 57 (excluding Sugarite Canyon State Park): youth only,FAD,10,16,27,26,69,15,26,24,65,12.923076923076923
DER-1-418,Unit 57 (excluding Sugarite Canyon State Park),ESWTD,10,14,11,26,51,14,11,25,50,16.8
DER-1-422,Unit 58,FAD,40,65,44,72,181,53,34,60,147,22.857142857142858
DER-1-423,Unit 58,FAD,35,40,66,56,162,33,54,51,138,21.304347826086957
DER-1-424,Unit 58: youth only,FAD,10,18,24,13,55,18,24,12,54,15.555555555555555
DER-1-425,Unit 58: youth only,ESWTD,15,2,4,15,21,2,4,13,19,66.3157894736842
DER-1-426,Unit 58,ESWTD,15,15,25,18,58,12,23,15,50,25.2
DER-1-429,Unit 59,FAD,40,49,23,60,132,45,18,54,117,28.717948717948723
DER-1-430,Unit 59,FAD,40,26,26,55,107,21,20,49,90,37.333333333333336
DER-1-431,Unit 59: youth only,FAD,5,10,15,23,48,10,15,23,48,8.75
DER-1-432,Unit 59: youth only,ESWTD,15,0,3,2,5,0,2,2,4,315.0
DER-1-433,Unit 59,ESWTD,15,7,18,37,62,5,14,36,55,22.90909090909091
DER-1-700,statewide,FAD,1,1185,113,262,1560,1168,112,253,1533,0.0547945205479452
DER-2-104,Unit 2A,FAD,40,48,39,54,141,45,32,54,131,25.64885496183206
DER-2-105,Unit 2A: private land only,FAD,15,7,0,4,11,5,0,4,9,140.0
DER-2-106,Unit 2A,FAD,80,115,163,293,571,83,117,193,393,17.099236641221374
DER-2-107,Unit 2A: private land only,FAD,15,8,9,7,24,8,8,4,20,63.0
DER-2-118,Unit 2B,FAD,130,130,128,113,371,114,110,93,317,34.44794952681388
DER-2-119,Unit 2B: youth only,FAD,20,3,5,4,12,2,4,4,10,168.00000000000003
DER-2-120,Unit 2B: private land only,FAD,10,1,0,0,1,0,0,0,1000000,0.00084
DER-2-121,Unit 2B,FAD,180,1338,1126,635,3099,862,636,347,1845,8.19512195121951
DER-2-122,Unit 2B: youth only,FAD,50,47,50,59,156,33,32,29,94,44.680851063829785
DER-2-123,Unit 2B: private land only,FAD,30,8,0,21,29,2,0,11,13,193.84615384615384
DER-2-129,Unit 2C,FAD,50,1091,883,519,2493,403,299,210,912,4.605263157894736
DER-2-130,Unit 2C: private land only,FAD,15,5,3,5,13,2,3,4,9,140.0
DER-2-141,Unit 4: Humphries/Rio Chama/Sargent WMAs only,FAD,10,68,27,36,131,67,25,34,126,6.666666666666667
DER-2-142,Unit 4: private land only,FAD,150,66,2,6,74,21,1,4,26,484.6153846153846
DER-2-146,Unit 5A: public land only,FAD,30,40,28,28,96,36,26,26,88,28.636363636363637
DER-2-147,Unit 5A: private land only,FAD,220,82,2,4,88,31,1,4,36,513.3333333333333
DER-2-152,Unit 5B,FAD,10,128,147,81,356,123,136,73,332,2.5301204819277108
DER-2-156,Units 6A and 6C,FAD,100,698,425,366,1489,634,415,343,1392,6.0344827586206895
DER-2-159,Unit 7,FAD,10,23,20,32,75,22,20,29,71,11.830985915492958
DER-2-160,Unit 7,FAD,15,41,91,95,227,31,37,45,113,11.150442477876107
DER-2-162,Unit 8: youth only,FAD,65,128,42,31,201,124,41,31,196,27.857142857142858
DER-2-163,Unit 8,FAD,65,1147,373,265,1785,1078,338,236,1652,3.305084745762712
DER-2-167,"Unit 9, including Water Canyon WMA",FAD,10,49,35,42,126,49,35,41,125,6.720000000000001
DER-2-168,"Unit 9, including Water Canyon WMA",FAD,15,30,30,36,96,29,28,33,90,13.999999999999998
DER-2-175,Unit 10,FAD,100,223,92,102,417,208,87,100,395,21.265822784810126
DER-2-178,Unit 12,FAD,20,26,26,31,83,16,22,30,68,24.705882352941178
DER-2-183,Unit 13,FAD,125,102,71,79,252,86,61,73,220,47.72727272727273
DER-2-184,Unit 13,FAD,75,97,154,169,420,75,126,130,331,19.033232628398792
DER-2-187,Unit 14,FAD,35,320,170,117,607,277,152,101,530,5.547169811320755
DER-2-188,Unit 14,FAD,25,283,331,184,798,249,294,154,697,3.012912482065997
DER-2-190,Unit 15,FAD,75,170,127,121,418,147,112,107,366,17.21311475409836
DER-2-191,Unit 15,FAD,25,57,69,93,219,45,47,72,164,12.804878048780488
DER-2-198,Unit 16,FAD,230,423,271,245,939,358,236,219,813,23.76383763837638
DER-2-199,Unit 16,FAD,175,214,315,265,794,165,269,220,654,22.477064220183486
DER-2-204,Unit 17,FAD,75,106,108,92,306,97,99,73,269,23.42007434944238
DER-2-205,Unit 17,FAD,75,212,272,232,716,183,225,183,591,10.65989847715736
DER-2-209,Unit 18,FAD,50,19,19,33,71,18,17,33,68,61.76470588235294
DER-2-210,Unit 18,FAD,40,76,138,129,343,57,101,84,242,13.884297520661157
DER-2-214,Unit 19: except WSMR and Ft. Bliss,FAD,10,139,83,64,286,122,59,42,223,3.766816143497758
DER-2-218,Unit 20,FAD,45,3,6,19,28,3,6,17,26,145.3846153846154
DER-2-219,Unit 20,FAD,25,82,89,105,276,77,73,82,232,9.051724137931034
DER-2-224,Unit 21,FAD,300,72,77,145,294,56,54,118,228,110.5263157894737
DER-2-225,Unit 21,FAD,200,162,234,328,724,124,204,286,614,27.36156351791531
DER-2-231,Unit 22,FAD,30,9,7,18,34,5,6,10,21,120.0
DER-2-232,Unit 22,FAD,25,38,30,69,137,23,14,33,70,30.0
DER-2-239,Unit 23: except Burro mountains hunt area. ,FAMD,205,74,53,103,230,53,44,79,176,97.8409090909091
DER-2-240,Unit 23: except Burro mountains hunt area. ,FAMD,50,75,143,120,338,46,101,96,243,17.28395061728395
DER-2-241,Unit 23: except Burro mountains hunt area. ,FAWTD,100,11,8,20,39,10,2,12,24,350.0
DER-2-242,Unit 23: except Burro mountains hunt area. ,FAWTD,50,24,22,59,105,12,13,41,66,63.63636363636363
DER-2-248,Unit 23: Burro mountains hunt area only. ,FAMD,40,201,110,110,421,173,83,96,352,9.545454545454547
DER-2-249,Unit 23: Burro mountains hunt area only. ,FAWTD,20,24,21,30,75,15,17,25,57,29.47368421052632
DER-2-250,Unit 23: Burro mountains hunt area only. ,FAWTD,50,53,64,79,196,32,42,52,126,33.33333333333333
DER-2-259,Unit 24: excluding Fort Bayard ,FAMD,135,101,82,80,263,92,69,68,229,49.51965065502183
DER-2-260,Unit 24: excluding Fort Bayard ,FAMD,85,138,183,232,553,114,148,134,396,18.030303030303028
DER-2-261,Unit 24: excluding Fort Bayard ,FAWTD,60,8,12,20,40,7,7,17,31,162.5806451612903
DER-2-262,Unit 24: excluding Fort Bayard ,FAWTD,40,15,34,38,87,10,26,26,62,54.19354838709678
DER-2-267,Unit 25,FAD,45,5,6,9,20,5,6,9,20,189.0
DER-2-268,Unit 25,FAD,30,48,43,65,156,41,38,58,137,18.394160583941606
DER-2-272,Unit 26,FAD,25,3,2,3,8,2,2,3,7,300.0
DER-2-273,Unit 26,FAD,15,26,24,29,79,17,22,25,64,19.6875
DER-2-281,Unit 27,FAMD,30,3,3,7,13,2,2,5,9,280.0
DER-2-282,Unit 27,FAWTD,15,4,3,6,13,4,2,5,11,114.54545454545455
DER-2-283,Unit 27,FAMD,30,64,38,39,141,46,28,27,101,24.95049504950495
DER-2-284,Unit 27,FAWTD,40,19,24,40,83,10,18,25,53,63.39622641509435
DER-2-291,Unit 29,FAD,100,0,3,9,12,0,2,8,10,840.0
DER-2-292,Unit 29,FAD,50,19,33,50,102,16,23,44,83,50.602409638554214
DER-2-297,Unit 30,FAD,200,53,65,75,193,31,44,62,137,122.62773722627738
DER-2-298,Unit 30,FAD,100,258,220,251,729,199,170,186,555,15.135135135135137
DER-2-302,Unit 31,FAD,175,87,81,142,310,51,63,98,212,69.33962264150944
DER-2-303,Unit 31,FAD,100,472,345,196,1013,359,253,136,748,11.229946524064172
DER-2-309,Unit 32,FAD,150,25,23,49,97,23,16,37,76,165.78947368421052
DER-2-310,Unit 32,FAD,100,120,171,209,500,97,144,142,383,21.93211488250653
DER-2-314,Unit 33,FAD,60,41,48,42,131,32,38,36,106,47.54716981132076
DER-2-315,Unit 33,FAD,50,322,284,180,786,220,205,121,546,7.6923076923076925
DER-2-323,Unit 34,FAD,450,294,230,228,752,251,190,200,641,58.97035881435257
DER-2-324,Unit 34,FAD,350,439,296,417,1152,349,257,356,962,30.561330561330564
DER-2-329,Unit 36,FAD,225,235,208,198,641,193,176,173,542,34.87084870848708
DER-2-330,Unit 36,FAD,125,238,323,309,870,189,270,260,719,14.603616133518777
DER-2-335,Unit 37,FAD,100,77,89,70,236,61,76,56,193,43.523316062176164
DER-2-336,Unit 37,FAD,80,101,158,146,405,73,130,120,323,20.804953560371516
DER-2-340,Unit 38,FAD,65,7,22,36,65,7,22,34,63,86.66666666666667
DER-2-341,Unit 38,FAD,40,47,59,94,200,47,53,90,190,17.68421052631579
DER-2-345,Unit 39,FAD,25,3,6,5,14,3,6,5,14,150.0
DER-2-346,Unit 39,FAD,15,9,15,18,42,9,15,16,40,31.5
DER-2-350,Unit 40,FAD,20,4,5,4,13,4,4,4,12,140.0
DER-2-351,Unit 40,FAD,15,8,13,28,49,6,13,24,43,29.30232558139535
DER-2-358,Unit 41,FAD,10,7,8,6,21,5,8,5,18,46.666666666666664
DER-2-359,Unit 41,FAD,10,21,12,15,48,20,12,12,44,19.090909090909093
DER-2-364,Unit 42,FAD,15,3,6,7,16,3,6,5,14,90.0
DER-2-367,Unit 43,FAD,10,10,16,25,51,8,16,25,49,17.142857142857142
DER-2-373,Unit 45,FAD,165,371,259,208,838,328,234,186,748,18.52941176470588
DER-2-377,Unit 47,FAD,10,4,7,8,19,4,7,8,19,44.21052631578948
DER-2-381,Unit 48,FAD,45,105,54,61,220,95,53,54,202,18.712871287128714
DER-2-385,Unit 49,FAD,105,263,157,150,570,246,143,140,529,16.67296786389414
DER-2-388,Unit 50,FAD,5,3,15,21,39,3,15,21,39,10.76923076923077
DER-2-390,Unit 51A,FAD,65,192,180,149,521,165,152,136,453,12.052980132450331
DER-2-393,Unit 51B,FAD,15,22,43,44,109,20,39,37,96,13.125
DER-2-396,Unit 52,FAD,80,155,173,124,452,134,166,114,414,16.231884057971016
DER-2-400,Unit 53,FAD,100,110,80,98,288,78,65,87,230,36.52173913043478
DER-2-403,Units 54/55: Colin Neblett WMA only,FAD,10,10,7,18,35,10,7,18,35,24.000000000000004
DER-2-408,Unit 55A: Valle Vidal only,FAD,10,141,60,60,261,136,60,57,253,3.320158102766799
DER-2-413,Unit 56,FAD,10,7,2,14,23,6,2,11,19,44.21052631578948
DER-2-419,Unit 57 (excluding Sugarite Canyon State Park),FAD,20,9,21,8,38,6,16,7,29,57.931034482758626
DER-2-420,Unit 57: Sugarite canyon state park only,FAD,20,114,59,37,210,105,49,28,182,9.230769230769232
DER-2-427,Unit 58,FAD,10,5,8,7,20,5,8,7,20,42.00000000000001
DER-2-434,Unit 59,FAD,10,1,0,8,9,1,0,8,9,93.33333333333333
DER-3-108,Unit 2A,FAD,50,79,72,73,224,75,68,66,209,20.095693779904305
DER-3-109,Unit 2A: private land only,FAD,10,2,4,1,7,2,4,1,7,120.0
DER-3-124,Unit 2B,FAD,175,137,182,237,556,130,163,203,496,29.63709677419355
DER-3-125,Unit 2B: youth only,FAD,20,9,12,17,38,8,11,13,32,52.5
DER-3-131,Unit 2C,FAD,20,294,516,343,1153,164,178,121,463,3.6285097192224622
DER-3-132,Unit 2C: private land only,FAD,9,3,1,1,5,1,1,1,3,252.0
DER-3-143,Unit 4: private land only,FAD,100,31,5,16,52,19,5,8,32,262.5
DER-3-148,Unit 5A: public land only,FAD,10,8,35,35,78,8,35,34,77,10.90909090909091
DER-3-149,Unit 5A: private land only,FAD,50,45,2,2,49,29,2,2,33,127.27272727272727
DER-3-153,Unit 5B,FAD,10,148,117,83,348,142,107,71,320,2.6250000000000004
DER-3-157,Units 6A and 6C,FAD,115,549,557,385,1491,505,514,335,1354,7.134416543574594
DER-3-161,Unit 7,FAD,25,37,65,78,180,33,52,43,128,16.40625
DER-3-169,"Unit 9, including Water Canyon WMA: restricted muzzleloader only",FAD,10,47,40,36,123,46,40,36,122,6.885245901639345
DER-3-176,Unit 10,FAD,90,165,143,119,427,163,132,116,411,18.394160583941606
DER-3-179,Unit 12,FAD,40,17,21,38,76,16,18,31,65,51.69230769230769
DER-3-185,Unit 13,FAD,200,124,164,203,491,113,147,193,453,37.086092715231786
DER-3-189,Unit 14,FAD,55,360,296,163,819,342,278,151,771,5.992217898832684
DER-3-192,Unit 15,FAD,165,344,239,255,838,303,206,219,728,19.038461538461537
DER-3-193,Unit 15: youth only,FAD,100,21,26,36,83,16,18,25,59,142.3728813559322
DER-3-200,Unit 16,FAD,300,282,303,277,862,245,261,247,753,33.46613545816733
DER-3-206,Unit 17,FAD,80,243,200,208,651,227,186,177,590,11.389830508474578
DER-3-211,Unit 18,FAD,75,34,40,104,178,29,38,93,160,39.375
DER-3-215,Unit 19: except the White Sands missile range portion and Ft. Bliss,FAD,10,119,59,51,229,103,53,41,197,4.2639593908629445
DER-3-220,Unit 20,FAD,85,34,56,75,165,34,51,70,155,46.06451612903225
DER-3-226,Unit 21,FAD,350,73,76,176,325,64,63,150,277,106.13718411552347
DER-3-233,Unit 22,FAD,65,21,27,35,83,16,22,29,67,81.49253731343283
DER-3-243,Unit 23: except the Burro mountains hunt area,FAMD,225,59,90,128,277,39,67,104,210,90.0
DER-3-244,Unit 23: except the Burro mountains hunt area,FAWTD,75,8,25,52,85,5,14,44,63,100.0
DER-3-251,Unit 23: Burro mountains hunt area only,FAMD,40,75,72,61,208,63,63,41,167,20.11976047904192
DER-3-252,Unit 23: Burro mountains hunt area only,FAWTD,40,33,24,44,101,31,18,36,85,39.529411764705884
DER-3-263,Unit 24: excluding Fort Bayard management area,FAMD,280,78,77,124,279,72,68,112,252,93.33333333333333
DER-3-264,Unit 24: excluding Fort Bayard management area,FAWTD,75,12,16,30,58,11,13,22,46,136.95652173913044
DER-3-269,Unit 25,FAD,45,21,11,40,72,18,9,38,65,58.153846153846146
DER-3-274,Unit 26,FAD,60,7,10,19,36,5,7,14,26,193.84615384615384
DER-3-285,Unit 27,FAMD,40,13,12,28,53,11,8,20,39,86.15384615384616
DER-3-286,Unit 27,FAWTD,50,18,22,32,72,8,14,18,40,105.0
DER-3-293,Unit 29,FAD,70,4,19,15,38,3,12,13,28,210.0
DER-3-299,Unit 30,FAD,325,158,106,176,440,117,88,137,342,79.82456140350878
DER-3-304,Unit 31,FAD,175,130,110,234,474,98,78,184,360,40.833333333333336
DER-3-311,Unit 32,FAD,175,72,61,103,236,63,52,88,203,72.41379310344827
DER-3-316,Unit 33: restricted muzzleloader only,FAD,140,91,63,128,282,75,49,104,228,51.57894736842105
DER-3-317,"Unit 33: Huey WMA only, youth only",ES,5,25,8,18,51,25,8,18,51,8.235294117647058
DER-3-318,"Unit 33: Huey WMA only, youth only",A,5,0,9,4,13,0,9,4,13,32.30769230769231
DER-3-325,Unit 34,FAD,340,234,177,349,760,203,165,304,672,42.49999999999999
DER-3-331,Unit 36,FAD,115,128,168,162,458,119,140,127,386,25.025906735751295
DER-3-332,Unit 36: youth only,FAD,25,4,7,19,30,2,7,18,27,77.77777777777779
DER-3-337,Unit 37,FAD,125,111,94,134,339,102,77,124,303,34.65346534653465
DER-3-342,Unit 38,FAD,100,29,40,57,126,29,40,56,125,67.2
DER-3-347,Unit 39,FAD,40,8,6,21,35,7,5,21,33,101.81818181818183
DER-3-352,Unit 40,FAD,30,2,1,12,15,2,0,10,12,210.0
DER-3-360,Unit 41,FAD,25,35,13,27,75,28,10,20,58,36.206896551724135
DER-3-365,Unit 42,FAD,15,7,5,21,33,7,3,19,29,43.44827586206896
DER-3-368,Unit 43,FAD,15,14,39,19,72,14,38,19,71,17.746478873239436
DER-3-374,Unit 45,FAD,160,313,241,306,860,293,222,273,788,17.055837563451778
DER-3-378,Unit 47,FAD,20,15,4,17,36,14,4,13,31,54.19354838709678
DER-3-382,Unit 48,FAD,30,54,59,55,168,54,52,44,150,16.799999999999997
DER-3-397,Unit 52: restricted muzzleloader only,FAD,25,85,66,75,226,76,56,67,199,10.552763819095476
DER-3-414,Unit 56,FAD,15,2,4,7,13,1,3,6,10,126.0
DER-3-421,Unit 57 (excluding Sugarite Canyon State Park),FAD,15,27,8,16,51,14,6,14,34,37.05882352941177
DER-3-428,Unit 58,FAD,25,8,19,13,40,8,15,11,34,61.76470588235294
DER-3-435,Unit 59,FAD,25,1,3,6,10,1,2,4,7,300.0
ELK-1-132,Unit 2,MB,85,1319,766,867,2952,1111,606,642,2359,3.0267062314540056
ELK-1-133,Unit 2,A,125,649,807,585,2041,645,798,583,2026,5.182625863770977
ELK-1-134,Unit 2 youth only,A,75,126,83,94,303,123,82,91,296,21.283783783783782
ELK-1-135,Unit 2C,A,75,245,480,598,1323,240,476,593,1309,4.81283422459893
ELK-1-138,Unit 5A public land only,MB,10,73,55,51,179,70,52,47,169,4.9704142011834325
ELK-1-139,Unit 5A public land only,A,10,26,17,41,84,26,17,41,84,10.0
ELK-1-140,Unit 5A public land only,MB,10,34,43,39,116,33,40,34,107,7.850467289719626
ELK-1-141,Unit 5A public land only,A,10,9,30,18,57,9,30,18,57,14.73684210526316
ELK-1-142,Unit 5A public land only,MB,10,12,29,33,74,11,29,29,69,12.173913043478262
ELK-1-143,Unit 5A public land only,A,10,6,15,25,46,6,15,25,46,18.26086956521739
ELK-1-144,Unit 5A public land only,MB,10,85,50,46,181,78,42,41,161,5.217391304347826
ELK-1-145,Unit 5A public land only,A,10,13,35,30,78,13,35,30,78,10.76923076923077
ELK-1-160,Unit 10,MB,70,589,379,362,1330,508,311,288,1107,5.311653116531165
ELK-1-161,Unit 10 youth only,A,120,74,61,62,197,74,61,62,197,51.16751269035533
ELK-1-162,Unit 10,A,100,183,275,290,748,183,275,290,748,11.229946524064172
ELK-1-165,Unit 4: Sargent WMA only,MB/A,10,407,188,119,714,396,185,118,699,1.201716738197425
ELK-1-166,Unit 4: Sargent WMA only,MB/A,10,98,192,71,361,94,186,69,349,2.4068767908309456
ELK-1-167,Unit 4: Sargent WMA only,MB/A,10,69,74,104,247,68,74,103,245,3.428571428571429
ELK-1-168,Unit 4: Sargent WMA only,MB/A,10,53,56,76,185,49,54,74,177,4.745762711864407
ELK-1-169,Unit 4: Sargent WMA only,A,10,42,27,32,101,42,27,32,101,8.316831683168317
ELK-1-170,"Unit 4: Sargent WMA only, youth only",A,10,20,29,20,69,20,29,19,68,12.352941176470589
ELK-1-173,Unit 4: Humphries/ Rio Chama WMAs only,MB/A,15,159,127,99,385,152,127,98,377,3.3421750663129974
ELK-1-174,Unit 4: Humphries/ Rio Chama WMAs only,MB/A,15,62,146,102,310,61,144,98,303,4.158415841584159
ELK-1-175,Unit 4: Humphries/ Rio Chama WMAs only,A,10,43,35,48,126,43,34,48,125,6.720000000000001
ELK-1-176,"Unit 4: Humphries/ Rio Chama WMAs only, youth only",A,15,27,33,29,89,27,33,29,89,14.157303370786517
ELK-1-177,Unit 4: Rio Chama WMA only,A,20,23,43,53,119,23,43,52,118,14.237288135593221
ELK-1-180,Unit 5B,MB,86,504,424,371,1299,426,334,265,1025,7.04780487804878
ELK-1-181,Unit 5B,A,59,200,160,173,533,200,160,173,533,9.298311444652906
ELK-1-182,Unit 5B,MB,86,130,311,253,694,104,234,161,499,14.476953907815629
ELK-1-183,Unit 5B,A,59,53,207,178,438,53,206,178,437,11.340961098398168
ELK-1-184,Unit 5B,MB,87,185,174,300,659,130,122,174,426,17.154929577464788
ELK-1-185,Unit 5B,A,59,93,66,153,312,89,64,152,305,16.24918032786885
ELK-1-186,Unit 5B,MB,87,261,181,272,714,160,145,214,519,14.080924855491329
ELK-1-189,Unit 50,MB,120,131,145,253,529,79,93,158,330,30.545454545454543
ELK-1-190,Unit 50,MB,125,73,108,215,396,54,60,137,251,41.832669322709165
ELK-1-191,Unit 50,A,42,58,39,75,172,58,39,75,172,20.511627906976745
ELK-1-192,Unit 50,A,45,62,82,124,268,62,82,124,268,14.104477611940297
ELK-1-195,Unit 51,MB,220,1973,1069,1142,4184,1460,766,825,3051,6.057030481809242
ELK-1-196,Unit 51,MB,220,293,1268,651,2212,220,961,436,1617,11.428571428571427
ELK-1-197,Unit 51,MB,220,277,330,958,1565,232,245,689,1166,15.849056603773585
ELK-1-198,Unit 51,A,251,642,408,631,1681,640,405,630,1675,12.587462686567164
ELK-1-199,Unit 51,A,251,236,747,495,1478,236,747,493,1476,14.284552845528456
ELK-1-200,Unit 51,A,252,317,364,797,1478,316,364,796,1476,14.341463414634145
ELK-1-207,Unit 52,MB,230,1090,1027,976,3093,842,768,689,2299,8.403653762505437
ELK-1-208,Unit 52,MB,230,327,833,752,1912,222,598,525,1345,14.364312267657992
ELK-1-209,Unit 52 youth only,A,80,86,69,121,276,86,68,119,273,24.615384615384617
ELK-1-210,Unit 52 mobility impaired only,A,56,55,23,38,116,55,23,38,116,40.55172413793103
ELK-1-211,Unit 52,A,73,333,448,456,1237,333,447,456,1236,4.961165048543689
ELK-1-212,Unit 52,A,115,317,414,463,1194,315,409,460,1184,8.158783783783784
ELK-1-216,Unit 6A,MB,100,1289,949,777,3015,980,711,638,2329,3.606698153714041
ELK-1-217,Unit 6A,MB,103,449,910,642,2001,328,695,445,1468,5.893732970027248
ELK-1-218,Unit 6A,A,99,535,353,641,1529,530,352,637,1519,5.474654377880184
ELK-1-225,Unit 6B,ES,15,2452,880,505,3837,1683,684,366,2733,0.4610318331503842
ELK-1-226,Unit 6B,A,20,174,192,152,518,174,191,152,517,3.249516441005803
ELK-1-227,Unit 6B,ES,20,819,923,493,2235,569,663,362,1594,1.053952321204517
ELK-1-228,Unit 6B,A,15,51,100,57,208,51,100,57,208,6.0576923076923075
ELK-1-229,Unit 6B youth only,A,35,120,78,50,248,120,78,50,248,11.85483870967742
ELK-1-230,Unit 6B,A,35,71,80,112,263,70,80,110,260,11.307692307692307
ELK-1-231,Unit 6B,A,35,76,106,116,298,76,106,116,298,9.865771812080537
ELK-1-232,Unit 6B youth only,A,35,68,82,71,221,67,82,71,220,13.363636363636363
ELK-1-233,Unit 6B,A,35,85,70,147,302,85,70,147,302,9.735099337748345
ELK-1-237,Unit 6C,MB,105,625,802,722,2149,507,575,544,1626,5.424354243542435
ELK-1-238,Unit 6C,MB,105,204,520,509,1233,160,382,308,850,10.376470588235295
ELK-1-239,Unit 6C,A,110,235,317,365,917,235,317,365,917,10.076335877862594
ELK-1-240,Unit 6C,A,110,170,260,322,752,170,260,321,751,12.303595206391476
ELK-1-244,Unit 7,MB,30,69,121,154,344,62,96,108,266,9.473684210526317
ELK-1-245,Unit 7,A,50,64,63,136,263,64,63,135,262,16.030534351145036
ELK-1-248,Unit 12,MB,35,611,303,290,1204,334,182,149,665,4.421052631578947
ELK-1-249,Unit 12,MB,60,198,383,249,830,114,249,127,490,10.285714285714285
ELK-1-250,Unit 12,MB,80,131,200,332,663,75,127,211,413,16.27118644067797
ELK-1-251,Unit 12,MB,80,111,150,287,548,62,79,191,332,20.240963855421686
ELK-1-252,Unit 12,A,60,159,106,138,403,159,106,137,402,12.53731343283582
ELK-1-253,Unit 12,A,60,60,186,116,362,60,186,116,362,13.922651933701658
ELK-1-254,Unit 12,A,64,53,67,197,317,53,67,197,317,16.9589905362776
ELK-1-274,Unit 16A mobility impaired only,MB,25,320,217,68,605,233,142,56,431,4.872389791183294
ELK-1-275,Unit 16A,MB,75,3633,2413,1440,7486,1717,1015,751,3483,1.8087855297157622
ELK-1-276,Unit 16A,MB,100,1027,1608,1156,3791,547,909,508,1964,4.276985743380855
ELK-1-277,Unit 16A,A,75,480,383,473,1336,474,381,472,1327,4.747550866616428
ELK-1-278,Unit 16A,A,75,86,332,252,670,86,329,251,666,9.45945945945946
ELK-1-281,Unit 16B/22,MB,25,840,425,582,1847,459,235,296,990,2.1212121212121215
ELK-1-282,Unit 16B/22,MB,80,214,518,283,1015,122,317,172,611,10.998363338788872
ELK-1-283,Unit 16B/22,MB,120,238,312,485,1035,147,206,316,669,15.067264573991032
ELK-1-286,Unit 16C youth only,ES,25,381,467,324,1172,298,278,181,757,2.7741083223249667
ELK-1-287,Unit 16C,MB,35,398,403,450,1251,325,287,295,907,3.241455347298787
ELK-1-288,Unit 16C,MB,65,169,394,330,893,129,296,195,620,8.806451612903226
ELK-1-289,Unit 16C,A,50,138,182,221,541,136,182,219,537,7.82122905027933
ELK-1-290,Unit 16C,A,48,37,117,89,243,37,116,89,242,16.66115702479339
ELK-1-293,Unit 16D mobility impaired only,MB,25,250,265,78,593,163,184,67,414,5.072463768115942
ELK-1-294,Unit 16D,MB,55,2707,2057,1173,5937,1190,841,717,2748,1.6812227074235808
ELK-1-295,Unit 16D,MB,50,571,946,756,2273,216,519,343,1078,3.896103896103896
ELK-1-296,Unit 16D,A,50,264,270,388,922,264,267,385,916,4.585152838427948
ELK-1-297,Unit 16D,A,50,72,190,210,472,72,189,210,471,8.9171974522293
ELK-1-300,Unit 16E youth only,ES,25,213,413,358,984,128,219,141,488,4.30327868852459
ELK-1-302,Unit 16E,MB,53,304,232,321,857,213,155,191,559,7.96422182468694
ELK-1-303,Unit 16E,A,75,100,92,177,369,100,92,177,369,17.073170731707318
ELK-1-304,Unit 16E,A,75,28,112,126,266,28,112,126,266,23.684210526315788
ELK-1-316,Unit 21A,MB,15,352,151,144,647,222,95,101,418,3.014354066985646
ELK-1-317,Unit 21A,MB,35,148,270,144,562,44,159,96,299,9.832775919732441
ELK-1-318,Unit 21A,MB,55,128,180,246,554,75,67,127,269,17.17472118959108
ELK-1-319,Unit 21A,A,30,55,60,99,214,55,60,98,213,11.830985915492958
ELK-1-323,Unit 21B,MB,10,86,57,78,221,66,50,69,185,4.54054054054054
ELK-1-324,Unit 21B,MB,15,23,66,44,133,17,43,36,96,13.125
ELK-1-325,Unit 21B,MB,25,22,59,90,171,17,50,49,116,18.103448275862068
ELK-1-326,Unit 21B,A,15,30,23,53,106,30,23,53,106,11.88679245283019
ELK-1-327,Unit 21B,A,15,10,26,25,61,10,26,25,61,20.65573770491803
ELK-1-328,Unit 21B,A,15,24,24,27,75,24,24,27,75,16.799999999999997
ELK-1-329,Unit 21B,A,20,13,18,32,63,13,18,32,63,26.666666666666668
ELK-1-333,Unit 23 youth only,ES,25,239,303,301,843,142,131,145,418,5.023923444976076
ELK-1-335,Unit 23,MB,75,306,283,505,1094,193,173,302,668,9.431137724550897
ELK-1-336,Unit 23,A,20,64,68,131,263,64,68,131,263,6.387832699619772
ELK-1-338,Unit 23: south of NM 78,A,20,11,29,48,88,11,29,48,88,19.090909090909093
ELK-1-342,Unit 24: excluding Ft. Bayard management area,MB,15,59,76,133,268,45,61,109,215,5.8604651162790695
ELK-1-343,"Unit 24: including Ft. Bayard management area, youth only",ES,5,121,83,55,259,120,80,55,255,1.647058823529412
ELK-1-344,"Unit 24: including Ft. Bayard management area, youth only",A,5,8,33,17,58,8,33,17,58,7.241379310344828
ELK-1-347,Unit 34 youth only,ES,75,2095,511,236,2842,1357,352,158,1867,3.3743974290305303
ELK-1-348,Unit 34 youth only,A,120,132,448,228,808,132,440,227,799,12.615769712140173
ELK-1-349,Unit 34 mobility impaired,ES,50,408,85,133,626,351,64,82,497,8.450704225352112
ELK-1-351,Unit 34,ES,150,5673,2856,2617,11146,4375,2107,1794,8276,1.5224746254229098
ELK-1-352,Unit 34,A,350,1106,1807,1222,4135,1103,1802,1207,4112,7.149805447470817
ELK-1-353,Unit 34,A,350,514,1297,1506,3317,504,1292,1496,3292,8.930741190765493
ELK-1-354,Unit 34,A,350,194,528,1210,1932,194,524,1202,1920,15.312500000000002
ELK-1-356,Unit 34,A,200,122,427,697,1246,119,426,689,1234,13.614262560777956
ELK-1-357,Unit 34,A,200,120,233,692,1045,119,232,689,1040,16.153846153846153
ELK-1-361,Unit 36,ES,140,2280,2413,2066,6759,1646,1560,1149,4355,2.700344431687715
ELK-1-362,Unit 36,ES,140,625,1905,1754,4284,440,1402,1069,2911,4.039848849192717
ELK-1-363,Unit 36,A,100,278,306,525,1109,272,304,520,1096,7.664233576642336
ELK-1-364,Unit 36,A,100,82,297,342,721,76,294,332,702,11.965811965811966
ELK-1-365,Unit 36,A,100,89,161,439,689,88,155,434,677,12.40768094534712
ELK-1-369,Unit 45,MB,140,420,409,537,1366,336,316,441,1093,10.759377859103385
ELK-1-370,Unit 45,MB,140,189,392,399,980,122,290,260,672,17.5
ELK-1-375,Unit 48,MB,75,253,204,210,667,192,159,148,499,12.625250501002002
ELK-1-376,Unit 48,MB,64,56,173,133,362,48,133,97,278,19.33812949640288
ELK-1-377,Unit 48,A,50,99,89,117,305,99,89,117,305,13.77049180327869
ELK-1-378,Unit 48,A,54,80,93,117,290,80,93,117,290,15.641379310344828
ELK-1-381,Unit 49,MB,77,650,458,470,1578,541,331,362,1234,5.241491085899513
ELK-1-382,Unit 49,MB,76,132,447,295,874,104,344,188,636,10.037735849056602
ELK-1-383,Unit 49,A,77,221,213,229,663,221,213,229,663,9.755656108597284
ELK-1-384,Unit 49,A,77,104,229,174,507,104,229,174,507,12.757396449704139
ELK-1-388,Unit 53: excluding Cerro portion,MB,80,138,140,140,418,99,96,89,284,23.661971830985916
ELK-1-389,Unit 53: excluding Cerro portion,MB,131,55,143,205,403,40,100,125,265,41.52452830188679
ELK-1-390,Unit 53: excluding Cerro portion,A,94,69,74,96,239,69,74,96,239,33.037656903765686
ELK-1-391,Unit 53: excluding Cerro portion,A,94,34,84,97,215,34,84,97,215,36.72558139534883
ELK-1-392,Unit 14,ES,10,153,72,94,319,140,67,86,293,2.8668941979522184
ELK-1-395,Unit 18,ES,10,215,126,137,478,138,99,119,356,2.359550561797753
ELK-1-396,"Unit 28: McGregor range only, military only",ES,10,73,9,6,88,32,6,4,42,20.0
ELK-1-397,Unit 28: McGregor range only,ES,10,89,94,72,255,65,49,65,179,4.692737430167598
ELK-1-400,"Units 29, 30",ES,20,996,479,379,1854,686,345,280,1311,1.2814645308924486
ELK-1-401,"Units 29, 30",ES,30,198,627,390,1215,167,535,287,989,2.5480283114256825
ELK-1-404,Unit 37,MB,30,812,535,570,1917,442,353,422,1217,2.0706655710764172
ELK-1-405,Unit 37,MB,30,163,391,405,959,109,253,291,653,3.859111791730475
ELK-1-406,Unit 37,A,45,65,68,191,324,65,67,191,323,11.702786377708978
ELK-1-408,Unit 38,ES,10,128,116,113,357,121,89,103,313,2.68370607028754
ELK-1-409,Unit 38,ES,10,23,85,66,174,23,81,56,160,5.250000000000001
ELK-1-410,"Units 39, 43",ES,30,143,76,131,350,128,70,124,322,7.826086956521738
ELK-1-413,"Units 42, 47, 59",ES,13,89,93,86,268,75,76,66,217,5.032258064516129
ELK-1-416,Unit 56,MB,10,124,53,73,250,112,52,70,234,3.5897435897435903
ELK-1-417,Unit 56,A,10,14,25,30,69,14,25,30,69,12.173913043478262
ELK-1-422,"Units 57 (excluding Sugarite Canyon State Park), 58",MB,5,60,76,46,182,59,73,44,176,2.3863636363636367
ELK-1-423,"Units 57 (excluding Sugarite Canyon State Park), 58",MB,10,34,75,56,165,29,71,50,150,5.6000000000000005
ELK-1-424,"Units 57 (excluding Sugarite Canyon State Park), 58",A,10,13,14,41,68,13,14,41,68,12.352941176470589
ELK-1-428,Unit 54/55: Colin Neblett WMA only,MB,20,17,30,32,79,17,30,32,79,21.265822784810126
ELK-1-429,Unit 54/55: Colin Neblett WMA only,MB,20,7,21,27,55,7,21,27,55,30.545454545454547
ELK-1-430,Unit 54/55: Colin Neblett WMA only,A,20,11,5,30,46,11,5,30,46,36.52173913043478
ELK-1-433,Unit 55A: ES Barker WMA only,MB,10,54,40,44,138,54,39,44,137,6.131386861313868
ELK-1-437,Unit 55A: Urraca WMA only,MB,10,22,23,29,74,22,23,29,74,11.351351351351353
ELK-1-438,Unit 55A: Urraca WMA only,MB,10,18,16,23,57,18,16,23,57,14.73684210526316
ELK-1-439,Unit 55A: Urraca WMA only,A,15,11,9,13,33,11,9,13,33,38.18181818181819
ELK-1-440,Unit 55A: Urraca WMA only,A,15,9,10,21,40,9,10,21,40,31.5
ELK-1-444,Unit 55A: Valle Vidal only,MB,35,1038,396,305,1739,702,232,215,1149,2.558746736292428
ELK-1-445,Unit 55A: Valle Vidal only,MB,30,206,324,189,719,134,202,88,424,5.943396226415095
ELK-1-446,"Unit 55A: Valle Vidal only, youth only",MB,20,463,169,126,758,352,106,78,536,3.134328358208956
ELK-1-447,"Unit 55A: Valle Vidal only, youth only",A,30,29,44,31,104,29,43,31,103,24.466019417475728
ELK-1-448,Unit 55A: Valle Vidal only,A,30,72,44,70,186,72,44,70,186,13.548387096774192
ELK-1-449,Unit 55A: Valle Vidal only,A,30,24,56,48,128,24,56,48,128,19.6875
ELK-1-700,statewide,MB,1,1064,142,295,1501,1046,133,271,1450,0.05793103448275862
ELK-2-129,Unit 2,ES,120,203,229,312,744,150,170,162,482,20.91286307053942
ELK-2-130,Unit 2,ES,120,381,425,427,1233,295,280,242,817,12.33782129742962
ELK-2-136,Unit 5A public land only,ES,5,14,8,11,33,13,5,9,27,15.555555555555555
ELK-2-137,Unit 5A public land only,ES,5,24,17,21,62,20,17,18,55,7.636363636363637
ELK-2-146,Unit 9 Marquez/LBar WMA only,ES,15,23,29,32,84,23,29,31,83,15.180722891566264
ELK-2-147,Unit 9 Marquez/LBar WMA only,ES,15,38,25,28,91,38,25,28,91,13.846153846153847
ELK-2-151,"Unit 9, including Water Canyon WMA",ES,82,54,38,97,189,43,28,74,145,47.50344827586206
ELK-2-152,"Unit 9, including Water Canyon WMA",ES,82,31,58,145,234,18,50,110,178,38.69662921348314
ELK-2-157,Unit 10,ES,125,180,233,193,606,129,168,118,415,25.301204819277107
ELK-2-158,Unit 10,ES,125,287,295,266,848,195,211,172,578,18.166089965397923
ELK-2-163,Unit 4: Sargent WMA only,ES,10,57,38,18,113,55,36,15,106,7.924528301886793
ELK-2-164,Unit 4: Sargent WMA only,ES,10,106,63,44,213,103,60,42,205,4.097560975609756
ELK-2-171,Unit 4: Humphries/Rio Chama WMAs only,ES,10,18,21,19,58,18,19,17,54,15.555555555555555
ELK-2-172,Unit 4: Humphries/Rio Chama WMAs only,ES,10,39,38,28,105,38,36,28,102,8.235294117647058
ELK-2-178,Unit 5B,ES,76,141,136,142,419,101,81,84,266,24.0
ELK-2-179,Unit 5B,ES,75,209,266,254,729,143,188,147,478,13.179916317991633
ELK-2-187,Unit 50,ES,60,27,32,132,191,10,13,80,103,48.932038834951456
ELK-2-188,Unit 50,ES,55,19,37,120,176,11,18,73,102,45.29411764705882
ELK-2-193,Unit 51,ES,180,377,508,442,1327,245,289,188,722,20.941828254847643
ELK-2-194,Unit 51,ES,180,682,798,676,2156,385,414,345,1144,13.216783216783215
ELK-2-202,Unit 52,ES,230,417,530,599,1546,234,286,305,825,23.418181818181814
ELK-2-203,Unit 52,ES,230,548,813,696,2057,328,433,323,1084,17.822878228782287
ELK-2-213,Unit 6A,ES,150,598,674,433,1705,401,372,227,1000,12.6
ELK-2-214,Unit 6A,ES,102,994,771,468,2233,671,504,279,1454,5.8927097661623105
ELK-2-219,Unit 6B,ES,25,834,292,149,1275,396,128,64,588,3.571428571428571
ELK-2-220,Unit 6B,A,10,62,32,31,125,62,32,31,125,6.720000000000001
ELK-2-221,Unit 6B,ES,25,1227,379,256,1862,611,204,154,969,2.1671826625387
ELK-2-222,Unit 6B,A,10,51,46,34,131,51,46,34,131,6.412213740458015
ELK-2-234,Unit 6C,ES,150,263,368,440,1071,196,244,227,667,18.89055472263868
ELK-2-235,Unit 6C,ES,105,359,575,504,1438,262,395,310,967,9.120992761116858
ELK-2-241,Unit 7,ES,15,18,19,34,71,15,14,27,56,22.5
ELK-2-242,Unit 7,ES,14,23,40,32,95,19,36,20,75,15.68
ELK-2-246,Unit 12,ES,36,105,130,138,373,47,75,70,192,15.75
ELK-2-247,Unit 12,ES,35,198,175,153,526,88,85,89,262,11.221374045801525
ELK-2-255,Unit 12,APRE/6,25,17,12,43,72,4,4,24,32,65.625
ELK-2-256,Unit 13,ES,202,418,439,480,1337,227,219,197,643,26.388802488335926
ELK-2-257,Unit 13,ES,148,698,650,494,1842,381,348,239,968,12.84297520661157
ELK-2-264,Unit 15,ES,350,1177,1548,1242,3967,650,720,398,1768,16.628959276018097
ELK-2-265,Unit 15,ES,250,2409,2116,1538,6063,1337,853,488,2678,7.8416728902165795
ELK-2-272,Unit 16A,ES,250,1078,1009,764,2851,357,430,277,1064,19.736842105263158
ELK-2-273,Unit 16A,ES,150,2220,1777,746,4743,631,551,311,1493,8.439383791024783
ELK-2-279,Unit 16B/22,ES,225,433,481,370,1284,156,196,211,563,33.57015985790409
ELK-2-280,Unit 16B/22,ES,165,591,639,515,1745,233,283,210,726,19.09090909090909
ELK-2-284,Unit 16C,ES,144,229,295,392,916,108,182,198,488,24.786885245901637
ELK-2-285,Unit 16C,ES,100,289,407,378,1074,168,209,171,548,15.328467153284672
ELK-2-291,Unit 16D,ES,90,848,580,440,1868,333,218,148,699,10.815450643776824
ELK-2-292,Unit 16D,ES,60,1881,825,510,3216,489,343,226,1058,4.763705103969754
ELK-2-298,Unit 16E,ES,90,93,125,219,437,43,54,126,223,33.90134529147982
ELK-2-299,Unit 16E,ES,60,84,195,161,440,25,101,77,203,24.82758620689655
ELK-2-305,Unit 17,ES,125,287,449,425,1161,135,187,155,477,22.0125786163522
ELK-2-306,Unit 17,ES,75,492,557,457,1506,250,255,212,717,8.786610878661087
ELK-2-314,Unit 21A,ES,50,101,135,128,364,57,80,65,202,20.792079207920793
ELK-2-315,Unit 21A,ES,50,202,180,186,568,89,75,96,260,16.153846153846153
ELK-2-320,Unit 21A,MB,15,8,13,38,59,2,10,22,34,37.05882352941177
ELK-2-321,Unit 21B,ES,25,39,42,114,195,5,19,74,98,21.428571428571427
ELK-2-322,Unit 21B,ES,25,48,61,76,185,22,32,40,94,22.340425531914892
ELK-2-330,Unit 21B,MB,15,0,8,10,18,0,5,10,15,84.0
ELK-2-331,Unit 23,ES,125,153,173,381,707,80,91,195,366,28.688524590163933
ELK-2-332,Unit 23,ES,75,149,295,376,820,66,141,176,383,16.449086161879894
ELK-2-337,Unit 23,MB,15,3,9,43,55,2,4,20,26,48.46153846153846
ELK-2-339,Unit 24: excluding Ft. Bayard management area,ES,15,17,28,47,92,13,17,37,67,18.80597014925373
ELK-2-340,Unit 24: excluding Ft. Bayard management area,ES,10,29,33,22,84,28,32,20,80,10.500000000000002
ELK-2-345,Unit 34,ES,200,1412,1674,812,3898,742,787,436,1965,8.549618320610687
ELK-2-346,Unit 34,ES,200,3001,1835,877,5713,1498,974,463,2935,5.724020442930153
ELK-2-355,Unit 34,APRE/6/A,200,115,89,394,598,67,56,295,418,40.19138755980861
ELK-2-358,Unit 36,ES,140,584,762,591,1937,290,307,246,843,13.950177935943058
ELK-2-359,Unit 36,ES,140,828,998,771,2597,423,503,405,1331,8.835462058602554
ELK-2-366,Unit 45,ES,75,193,261,172,626,118,137,79,334,18.862275449101794
ELK-2-367,Unit 45,ES,73,299,308,273,880,173,169,149,491,12.488798370672098
ELK-2-372,Unit 48,ES,80,93,72,156,321,58,40,86,184,36.52173913043478
ELK-2-373,Unit 48,ES,80,106,128,153,387,67,97,96,260,25.846153846153847
ELK-2-379,Unit 49,ES,60,187,252,204,643,138,151,95,384,13.125
ELK-2-380,Unit 49,ES,59,327,293,194,814,254,200,125,579,8.559585492227978
ELK-2-385,Unit 53,ES,65,57,63,130,250,30,34,57,121,45.12396694214876
ELK-2-386,Unit 53,ES,60,66,78,107,251,36,50,54,140,36.0
ELK-2-393,Unit 18,ES,25,11,34,37,82,6,21,14,41,51.21951219512195
ELK-2-394,Unit 18,ES,25,46,54,78,178,29,33,34,96,21.875
ELK-2-398,"Units 29, 30",ES,20,93,79,76,248,64,50,42,156,10.76923076923077
ELK-2-399,"Units 29, 30",ES,20,208,186,177,571,146,135,113,394,4.2639593908629445
ELK-2-402,Unit 37,ES,40,107,145,195,447,62,77,95,234,14.358974358974361
ELK-2-403,Unit 37,ES,30,201,203,247,651,100,129,154,383,6.579634464751958
ELK-2-407,Unit 37,APRE/6,50,13,28,71,112,10,17,43,70,60.0
ELK-2-411,"Units 42, 47, 59",ES,13,15,13,21,49,7,8,14,29,37.6551724137931
ELK-2-412,"Units 42, 47, 59",ES,13,11,25,29,65,6,16,19,41,26.634146341463417
ELK-2-414,Unit 56,ES,5,9,14,5,28,9,13,5,27,15.555555555555555
ELK-2-415,Unit 56,ES,5,22,15,12,49,21,15,12,48,8.75
ELK-2-418,Unit 57: Sugarite canyon state park only,ES,3,6,8,8,22,6,8,8,22,11.454545454545455
ELK-2-419,Unit 57: Sugarite canyon state park only,ES,2,10,9,8,27,10,8,8,26,6.461538461538462
ELK-2-420,"Units 57 (excluding Sugarite Canyon State Park), 58",ES,5,9,7,10,26,9,7,10,26,16.153846153846153
ELK-2-421,"Units 57 (excluding Sugarite Canyon State Park), 58",ES,5,18,20,4,42,18,20,4,42,10.0
ELK-2-425,Unit 54: Colin Neblett WMA only,ES,10,3,8,12,23,3,8,12,23,36.52173913043478
ELK-2-426,Unit 54: Colin Neblett WMA only,ES,10,10,2,18,30,10,2,18,30,28.000000000000004
ELK-2-431,Unit 55A: ES Barker WMA only,ES,5,8,3,4,15,8,3,4,15,28.000000000000004
ELK-2-432,Unit 55A: ES Barker WMA only,ES,5,21,14,8,43,21,14,8,43,9.767441860465116
ELK-2-434,Unit 55A: Urraca WMA only,ES,5,10,5,3,18,10,5,3,18,23.333333333333332
ELK-2-435,Unit 55A: Urraca WMA only,ES,5,12,8,9,29,12,8,9,29,14.482758620689657
ELK-2-441,Unit 55A: Valle Vidal only,ES,25,219,118,82,419,87,45,11,143,14.685314685314685
ELK-2-442,Unit 55A: Valle Vidal only,ES,25,416,179,149,744,187,60,78,325,6.461538461538462
ELK-3-131,Unit 2,MB,135,500,437,516,1453,424,311,314,1049,10.81029551954242
ELK-3-148,Unit 9 Marquez/LBar WMA only,MB,15,70,44,33,147,70,44,33,147,8.571428571428571
ELK-3-149,Unit 9 Marquez/LBar WMA only,MB,15,13,56,24,93,13,56,24,93,13.548387096774192
ELK-3-150,Unit 9 Marquez/LBar WMA only,MB,15,20,13,37,70,20,13,37,70,18.0
ELK-3-153,"Unit 9, including Water Canyon WMA - mobility impaired only",MB,21,10,1,17,28,10,1,14,25,70.56
ELK-3-154,"Unit 9, including Water Canyon WMA",MB,35,27,27,43,97,26,21,35,82,35.853658536585364
ELK-3-155,"Unit 9, including Water Canyon WMA",MB,35,34,43,33,110,32,35,22,89,33.03370786516854
ELK-3-156,"Unit 9, including Water Canyon WMA",MB,21,6,13,66,85,5,9,51,65,27.138461538461538
ELK-3-159,Unit 10,MB,70,202,200,239,641,139,169,180,488,12.049180327868852
ELK-3-201,Unit 51,ES,145,143,174,342,659,96,139,231,466,26.13733905579399
ELK-3-204,Unit 52 mobility impaired only,MB,50,28,12,38,78,25,11,31,67,62.68656716417911
ELK-3-205,Unit 52,MB,120,424,354,404,1182,268,208,222,698,14.441260744985673
ELK-3-206,Unit 52,A,50,80,98,89,267,80,98,89,267,15.730337078651685
ELK-3-215,Unit 6A,MB,104,653,498,427,1578,473,343,306,1122,7.786096256684492
ELK-3-223,Unit 6B,ES,15,868,389,282,1539,504,249,163,916,1.375545851528384
ELK-3-224,Unit 6B,A,20,89,62,46,197,88,62,46,196,8.571428571428571
ELK-3-236,Unit 6C,MB,155,330,451,464,1245,238,318,276,832,15.649038461538462
ELK-3-243,Unit 7,MB,24,31,53,75,159,28,36,48,112,18.0
ELK-3-258,Unit 13 youth only,ES,30,153,167,151,471,114,97,80,291,8.65979381443299
ELK-3-259,Unit 13,MB,86,528,461,419,1408,333,280,236,849,8.508833922261482
ELK-3-260,Unit 13,MB,126,135,385,303,823,78,240,156,474,22.32911392405063
ELK-3-261,Unit 13,MB,126,128,209,418,755,76,105,231,412,25.68932038834951
ELK-3-262,Unit 13,A,117,115,109,170,394,115,109,170,394,24.944162436548222
ELK-3-263,Unit 13,A,116,32,113,133,278,32,113,133,278,35.05035971223022
ELK-3-266,Unit 15 youth only,ES,25,411,303,187,901,273,160,102,535,3.925233644859813
ELK-3-267,Unit 15,MB,200,1945,1174,1196,4315,1300,651,732,2683,6.261647409616102
ELK-3-268,Unit 15,MB,245,364,1173,642,2179,226,742,322,1290,15.953488372093021
ELK-3-269,Unit 15,MB,250,242,373,894,1509,136,199,504,839,25.029797377830754
ELK-3-270,Unit 15,A,250,419,359,476,1254,419,359,476,1254,16.74641148325359
ELK-3-271,Unit 15,A,250,75,340,377,792,75,340,377,792,26.515151515151516
ELK-3-301,Unit 16E,MB,70,86,149,180,415,38,71,107,216,27.22222222222222
ELK-3-307,Unit 17 youth only,ES,25,81,128,196,405,57,76,99,232,9.051724137931034
ELK-3-308,Unit 17,MB,100,345,448,427,1220,216,278,240,734,11.444141689373296
ELK-3-309,Unit 17,MB,100,102,262,321,685,51,145,170,366,22.950819672131146
ELK-3-310,Unit 17,MB,25,154,116,195,465,40,46,102,188,11.170212765957446
ELK-3-311,Unit 17,A,25,30,40,49,119,30,40,49,119,17.647058823529413
ELK-3-312,Unit 17,A,100,34,78,111,223,34,78,111,223,37.66816143497758
ELK-3-313,Unit 17,A,100,13,51,155,219,13,51,155,219,38.35616438356164
ELK-3-334,Unit 23,MB,75,86,137,206,429,38,69,123,230,27.391304347826086
ELK-3-341,Unit 24: excluding Ft. Bayard management area,MB,15,11,25,42,78,8,23,35,66,19.090909090909093
ELK-3-350,Unit 34,ES,250,1478,1311,1166,3955,1009,767,689,2465,8.519269776876268
ELK-3-360,Unit 36,ES,140,850,755,711,2316,471,397,380,1248,9.423076923076923
ELK-3-368,Unit 45,MB,136,176,209,278,663,107,148,175,430,26.567441860465113
ELK-3-371,Unit 45,A,49,55,51,69,175,54,51,66,171,24.07017543859649
ELK-3-374,Unit 48,MB,60,86,72,102,260,62,50,72,184,27.391304347826086
ELK-3-387,Unit 53: excluding Cerro portion,ES,50,55,54,81,190,35,33,45,113,37.16814159292036
ELK-3-427,Unit 54: Colin Neblett WMA only,MB,20,6,17,21,44,6,17,21,44,38.18181818181819
ELK-3-436,Unit 55A: Urraca WMA only,MB,10,10,14,10,34,10,14,10,34,24.705882352941178
ELK-3-443,Unit 55A: Valle Vidal only,MB,20,369,158,104,631,200,58,39,297,5.656565656565657
IBX-1-101,"Unit 25 Florida mountains, once-in-a-lifetime",ES,15,7798,552,323,8673,4326,407,226,4959,0.2540834845735027
IBX-1-102,Unit 25 Florida mountains,F-IM,20,279,1589,585,2453,200,1316,498,2014,0.8341608738828202
IBX-1-103,"Unit 25 Florida mountains, once-in-a-youth",ES,5,481,53,10,544,449,37,6,492,0.853658536585366
IBX-1-105,Unit 25 Florida mountains,F-IM,20,352,641,1638,2631,224,514,1411,2149,0.7817589576547231
IBX-2-100,Unit 25 Florida mountains,ES,100,226,326,354,906,160,228,249,637,13.186813186813188
IBX-2-104,Unit 25 Florida mountains,ES,100,294,494,687,1475,153,320,428,901,9.32297447280799
IBX-3-106,Unit 25 Florida mountains,ES,15,461,2430,344,3235,271,1216,253,1740,0.7241379310344828
JAV-1-100,"Statewide except GMU 28, youth only",ES,180,287,25,7,319,263,24,6,293,51.60409556313993
JAV-1-102,"GMUs 19, 23, 24, 25, 26 and 27",ES,1100,2030,620,54,2704,1753,560,54,2367,39.036755386565275
JAV-1-105,"GMU 28 McGregor range, military only",ES,5,14,9,3,26,5,8,2,15,28.000000000000004
JAV-1-106,GMU 28 McGregor range,ES,5,209,489,241,939,207,470,231,908,0.46255506607929514
JAV-2-101,"GMUs 19, 23, 24, 25, 26 and 27",ES,330,479,382,226,1087,395,333,222,950,29.17894736842105
ORX-1-100,GMU 19 WSMR: Stallion Range,ES,70,2514,640,418,3572,2054,499,340,2893,2.032492222606291
ORX-1-101,GMU 19 WSMR: Rhodes Canyon,ES,70,1469,1381,482,3332,1213,1108,373,2694,2.1826280623608016
ORX-1-102,"GMU 19 WSMR: Rhodes Canyon, resident veteran only",ES,75,676,61,41,778,648,61,40,749,8.411214953271028
ORX-1-103,GMU 19 WSMR: Stallion Range,ES,70,1975,1435,1015,4425,1484,1177,804,3465,1.6969696969696968
ORX-1-104,GMU 19 WSMR: Rhodes Canyon,ES,70,2148,1672,921,4741,1455,1328,711,3494,1.6828849456210646
ORX-1-105,GMU 19 WSMR: Stallion Range,ES,70,2861,1982,1376,6219,1973,1274,1012,4259,1.3806057760037567
ORX-1-106,GMU 19 WSMR: Rhodes Canyon,ES,70,1427,2333,1600,5360,895,1592,1016,3503,1.678561233228661
ORX-1-107,GMU 19 WSMR: Stallion Range,ES,70,1486,2164,1869,5519,1014,1517,1408,3939,1.4927646610814926
ORX-1-108,GMU 19 WSMR: Rhodes Canyon,ES,70,1084,1649,1632,4365,635,1141,1196,2972,1.9784656796769853
ORX-1-109,GMU 19 WSMR: Stallion Range,ES,70,1247,995,1973,4215,910,727,1443,3080,1.909090909090909
ORX-1-110,"GMU 19 WSMR: Stallion Range, mobility impaired only",ES,20,209,25,15,249,178,22,14,214,7.850467289719626
ORX-1-111,"GMU 19 WSMR: Stallion Range, once-in-a-youth",ES,40,2138,46,56,2240,1758,38,25,1821,1.8451400329489294
ORX-1-112,GMU 19 WSMR: Stallion Range,BHO,15,511,298,260,1069,488,280,235,1003,1.2562313060817547
ORX-1-113,GMU 19 WSMR: Rhodes Canyon,BHO,15,311,320,220,851,293,298,187,778,1.6195372750642671
ORX-1-114,GMU 19 WSMR: Stallion Range,BHO,15,361,433,356,1150,339,401,325,1065,1.1830985915492958
ORX-1-115,GMU 19 WSMR: Rhodes Canyon,BHO,15,357,405,323,1085,323,373,296,992,1.2701612903225805
ORX-1-116,GMU 19 WSMR: Stallion Range,BHO,15,563,545,524,1632,509,497,458,1464,0.8606557377049181
ORX-1-117,GMU 19 WSMR: Rhodes Canyon,BHO,15,304,502,463,1269,270,452,409,1131,1.1140583554376657
ORX-1-118,GMU 19 WSMR: Stallion Range,BHO,15,263,545,566,1374,228,486,507,1221,1.0319410319410318
ORX-1-119,GMU 19 WSMR: Rhodes Canyon,BHO,15,230,416,525,1171,201,352,474,1027,1.2268743914313536
ORX-1-120,GMU 19 WSMR: Stallion Range,BHO,15,251,295,550,1096,220,264,479,963,1.308411214953271
ORX-1-204,"statewide, off-range",ES,96,1801,785,912,3498,1518,628,758,2904,2.7768595041322315
ORX-1-205,"statewide, off-range, youth only",ES,24,197,199,92,488,144,164,80,388,5.195876288659794
ORX-1-206,"statewide, off-range",ES,96,565,1593,865,3023,484,1323,727,2534,3.1823204419889506
ORX-1-207,"statewide, off-range, youth only",ES,24,45,208,158,411,35,157,140,332,6.072289156626506
ORX-1-208,"statewide, off-range",ES,96,813,918,1634,3365,696,791,1341,2828,2.851485148514852
ORX-1-209,"statewide, off-range, youth only",ES,24,69,134,216,419,55,118,170,343,5.877551020408163
ORX-1-210,"statewide, off-range",ES,96,1067,862,1071,3000,969,733,905,2607,3.093210586881473
ORX-1-211,"statewide, off-range, youth only",ES,24,69,109,122,300,63,88,106,257,7.844357976653697
ORX-1-212,"statewide, off-range",ES,96,987,1178,1127,3292,889,1022,935,2846,2.833450456781448
ORX-1-213,"statewide, off-range, youth only",ES,24,83,140,128,351,74,130,104,308,6.545454545454546
ORX-1-214,"statewide, off-range",ES,96,1057,1292,1318,3667,942,1167,1088,3197,2.5223647169221146
ORX-1-215,"statewide, off-range, youth only",ES,24,56,164,162,382,48,150,145,343,5.877551020408163
ORX-1-216,"statewide, off-range",ES,96,1268,1448,1750,4466,1109,1249,1516,3874,2.0815694372741356
ORX-1-217,"statewide, off-range, youth only",ES,24,93,181,203,477,80,147,181,408,4.9411764705882355
ORX-1-218,"statewide, off-range",ES,96,1354,1776,1906,5036,1094,1467,1582,4143,1.9464156408399709
ORX-1-219,"statewide, off-range, youth only",ES,24,70,167,181,418,46,142,158,346,5.826589595375722
ORX-1-220,"statewide, off-range",ES,80,917,2035,2065,5017,732,1643,1706,4081,1.646655231560892
ORX-1-221,"statewide, off-range, youth only",ES,20,49,151,213,413,42,125,169,336,5.0
ORX-1-222,"statewide, off-range, age 70 and older",ES,40,451,133,187,771,422,114,159,695,4.83453237410072
ORX-1-223,"statewide, off-range",ES,96,850,1057,2489,4396,696,846,2063,3605,2.236893203883495
ORX-1-224,"statewide, off-range, youth only",ES,24,65,125,225,415,58,88,187,333,6.054054054054054
ORX-1-225,GMU 28 McGregor range,ES,25,1384,682,349,2415,1124,537,281,1942,1.0813594232749741
ORX-1-226,"GMU 28 McGregor range, military only",ES,25,144,83,18,245,98,56,11,165,12.727272727272727
ORX-1-227,GMU 28 McGregor range,ES,25,658,1180,535,2373,518,934,421,1873,1.1211959423384943
ORX-1-228,"GMU 28 McGregor range, military only",ES,25,67,140,36,243,52,98,23,173,12.138728323699421
